F-ZERO ADVANAFZJ|Ｆ－ＺＥＲＯ赛车之最高时速|F-Zero for Game Boy Advance (J)
SUPER MARIOAAMAJ|超级玛丽奥|Super Mario Advance (J)
ROCKMAN_EXE AREJ|洛克人ＥＸＥ|Battle Network Rockman EXE (J)
KURURIN     AKRJ|滚滚欢乐球|Kurukuru Kururin (J)
MR. DRILLER2AD2J|钻地先生２|Mr. Driller 2 (J)
CHUCHUROCKETACRJ|咻咻火箭队|Chu Chu Rocket! (J)
DRACULA AGB1AAMJ|恶魔城-月之轮回|Akumajou Dracula - Circle of the Moon (J)
ADVANCE GTA AG7J|ＧＴＡ赛车|Advance GTA (J)
WAIWAI      AKWJ|科纳米哇哇赛车|Konami Wai Wai Racing Advance (J)
DODGEBALL F ADFJ|超级躲避球|Bakunetsu Dodge Ball Fighters (J)
PINOBEE     APBJ|匹诺比大冒险之寻找灵魂|Pinobee no Daibouken (J)
PAWAPOKE3   AP3J|强力职业棒球３|Power Pro Kun Pocket 3 (J)
NAPOLEON    ANPJ|拿破仑|Napoleon (J)
GT-CHAMP    AGTJ|全日本ＧＴ冠军赛车|Zen-Nihon GT Senshuken (J)
FPA         AFPJ|火爆摔角|Fire Pro Wrestling A (J)
TWEETY PARTYAMJJ|金丝雀舞会|Tweety no Hearty Party (J)
GOLFMASTER  AGRJ|公认随身高尔夫大师|JGTO Kounin Golf Master - Japan Golf Tour Game (J)
WINNINGPOST AWPJ|赛马大亨|Winning Post for Game Boy Advance (J)
SILENT HILL ASHJ|寂静岭|Play Novel - Silent Hill (J)
YU-GI-OH DDMAYDJ|游戏王-怪兽龙门骰|Yu-Gi-Oh! - Dungeon Dice Monsters (J)
BOKUKAN AGB ABCJ|我是航空管制官|Boku ha Koukuu Kanseikan (J)
JPOCKET     AJPJ|口袋Ｊ联盟足球２|J.League Pocket (J)
MOMO MATSURIAMMJ|桃太郎祭典|Momotarou Matsuri (J)
MONSTERGUARDAMNJ|怪兽使|Monster Guardians (J)
SUPER MARIOAAMZE|超级玛丽奥|Super Mario Advance (UE)(Beta)
FINAL FIGHT AFFJ|快打旋风|Final Fight One (J)
BOMSTORY    ABSJ|炸弹人锦标赛|Bomberman Story (J)
IRIDION3D   AI3E|伊登战机３Ｄ|Iridion 3D (UE)
PINOBEE     APBE|匹诺比大冒险之寻找灵魂|Pinobee - Wings of Adventure (UE)
R2RBOXING R2AR2E|爆笑拳击２|Ready 2 Rumble Boxing - Round 2 (U)
KRAZY RACERSAKWE|柯拿米快乐小赛车|Konami Krazy Racers (U)
DRACULA AGB1AAMP|恶魔城-月之轮回|Castlevania (E)
TONY HAWK 2!ATHE|汤尼霍克专业滑板２|Tony Hawk's Pro Skater 2 (UE)
GT ADVANCE CACAE|ＧＴ冠军赛车|GT Advance - Championship Racing (UE)
NAMCOMUSEUM ANME|南梦宫博物馆|Namco Museum (U)
CHUCHUROCKETACRE|咻咻火箭队|Chu Chu Rocket! (U)
EWJ         AEJE|蚯蚓吉姆|Earthworm Jim (UE)
PITFALL     APFE|玛雅历险记|Pitfall - The Mayan Adventure (UE)
ARMY MEN ADVASAE|玩具兵大战|Army Men Advance (UE)
SUPERDODGE  ADFE|爆热躲避球|Super Dodge Ball Advance (U)
F-ZERO ADVANAFZE|Ｆ－ＺＥＲＯ赛车之最高时速|F-Zero - Maximum Velocity (UE)
FP US       AFPE|火爆摔角|Fire Pro Wrestling (UE)
KRAZY RACERSAKWP|柯拿米快乐小赛车|Konami Krazy Racers (E)
R2RBOXING R2AR2P|爆笑拳击２|Ready 2 Rumble Boxing - Round 2 (E)
DRACULA AGB1AAME|恶魔城-月之轮回|Castlevania - Circle of the Moon (U)
RAYMAN      ARYE|雷曼３|Rayman Advance (U)
TOGRE GAIDENATOJ|皇家骑士团外传|Tactics Ogre Gaiden - The Knight of Lodis (J)
KURURIN     AKRP|滚滚欢乐球|Kurukuru Kururin (E)
TGGT-CHAMP  ATCP|全日本ＧＴ冠军赛车|Top Gear GT Championship (E)
SUPER MARIOAAMAE|超级玛丽奥|Super Mario Advance (UE)
RAYMAN      ARYP|雷曼３|Rayman Advance (E)
TWEETY MAGICATMP|金丝雀舞会|Tweety and the Magic Gems (E)
TONY HAWK 2!ATHD|汤尼霍克专业滑板２|Tony Hawk's Pro Skater 2 (G)
Y-RHAPSODY  AYRJ|优骏赛马|Narikiri Jockey Game - Yuushun Rhapsody (J)
CQADVANCE   AQAJ|可爱赛车Ｑ２|Choro Q Advance (J)
TOYROBOFORCEATRJ|玩具机器人大战|Toyrobo Force (J)
HOT POTATO  AHPE|热洋芋片|Hot Potato! (U)
BOMSTORYUSA ABSE|炸弹人锦标赛|Bomberman Tournament (UE)
TONY HAWK 2!ATHF|汤尼霍克专业滑板２|Tony Hawk's Pro Skater 2 (F)
BOF1        ABFJ|龙战士|Breath of Fire - Ryuu no Senshi (J)
KCEJDM5EX1  AY5J|游戏王５|Yu-Gi-Oh! - Duel Monsters 5 Expert 1 (J)
SSF2XREVIVALAXRJ|超级街霸ＩＩＸ-挑战者|Super Street Fighter II X - Revival (J)
MAHJONGKEIJIAMPJ|麻雀刑事|Mahjong Keiji (J)
PACMANCOLLE APCE|吃豆子全集|Pac-Man Collection (U)
TWEETY MAGICATMF|金丝雀舞会|Titi et les Bijoux Magiques (F)
EX MONOPOLY AMOJ|大富翁|EX Monopoly (J)
KABUTO      AB7J|全民饲育系列-我的独角仙|Minna no Shiiku Series 1 - Boku no Kabuto Mushi (J)
GETBACKERS  AGBJ|闪灵２人组|GetBackers Dakkanya - Jigoku no Scaramouche (J)
HEXCITE AGB AJSJ|宇宙战舰Ｘ|Space Hexcite - Maetel Legend EX (J)
KLONOA      AKLJ|风之少年-传说的星之徽章|Kaze no Klonoa - Yumemiru Teikoku (J)
MARIO KART  AMKJ|玛丽奥赛车|Mario Kart Advance (J)
DORAEMON    ADRJ|小叮当-绿之惑星拯救作战|Doraemon - Midori no Wakusei Dokidoki Daikyuushutsu! (J)
JP3 THE DNA ADNE|侏罗纪公园３-ＤＮＡ因子|Jurassic Park III - The DNA Factor (U)
KINNIKU AGB AK4J|筋肉番付-金刚君之大冒险|Kinniku Banzuke - Kongou-kun no Daibouken! (J)
GOLFMASTER MAGMJ|公认随身高尔夫大师|JGTO Kounin Golf Master Mobile - Japan Golf Tour Game (J)
ZEROTOURS   AZTJ|零度旅行|Zero-Tours (J)
STARCOM     ASKJ|星际通讯战|Sutakomi - Star Communicator (J)
MB BASEBALL AMBJ|职业棒球-行动版|Mobile Pro Yakyuu - Kantoku no Saihai (J)
OugonTaiyo_AAGSJ|黄金的太阳-开启的封印|Ougon no Taiyou - Hirakareshi Fuuin (J)
DOKAPON-Q   ADQJ|多卡波王国-Ｑ怪兽猎人|Dokapon Q - Monster Hunter! (J)
KUWAGATA    AW7J|全民饲育系列2-我的锹形虫|Minna no Shiiku Series 2 - Boku no Kuwagata (J)
JP3KYORYUNIAAJ3J|侏罗纪公园３-公园建造者|Jurassic Park III - Kyouryuu ni Ainiikou! (J)
FINAL FIGHT AFFP|快打旋风|Final Fight One (E)
BASS ADVANCEAABJ|超级黑巴斯钓鱼|Super Black Bass Advance (J)
MEINELIEBE  AYMJ|耽美梦想|Tanbi Musou - Meine Liebe (J)
MARIO KART  AMKE|玛丽奥赛车|Mario Kart - Super Circuit (U)
KIWAME-MS21 AKMJ|终极麻将-未来战士２１|Kiwame Mahjong Deluxe - Mirai Senshi 21 (J)
FORTRESS    AFOE|城堡建筑战|Fortress (UE)
JP3 THE DNA ADNP|侏罗纪公园３-ＤＮＡ因子|Jurassic Park III - The DNA Factor (E)
WARIOLAND   AWAJ|瓦里奥４|Wario Land Advance (J)
TWEETY MAGICATMD|金丝雀舞会|Tweety and the Magic Gems (G)
JP3ADVANCEDAAJQJ|侏罗纪公园３-动作版|Jurassic Park III - Advanced Action (J)
ESPN GOLF   AGRE|ESPN高尔夫总决赛2002|ESPN Final Round Golf 2002 (U)
TANG TANG   ATAE|轰炸所罗门|Tang Tang (U)
ADVANCEWARS AWRE|大战争|Advance Wars (U)
F14-TOMCAT  AFTE|Ｆ１４雄猫战斗机|F-14 Tomcat (UE)
LOVEHINAADVAALHJ|纯情房东俏房客-祝福之钟声|Love Hina Advance - Shukufuku no Kane ha Naru Kana (J)
MEN IN BLACKAMIP|ＭＩＢ星际战警|Men in Black - The Series (E)
ESPN GOLF   AGRP|ESPN高尔夫总决赛2002|ESPN Final Round Golf (E)
MEDAROTNVKWGAVIJ|徽章战士-锹型虫版|Medarot Navi - Kuwagata (J)
MEDAROTNVKBTANAJ|徽章战士-甲胄版|Medarot Navi - Kabuto (J)
ATLANTIS    ATLE|失落的帝国-亚特兰提斯|Atlantis - The Lost Empire (UE)
JP3PARKBUILDAJ3P|侏罗纪公园３-公园建造者|Jurassic Park III - Park Builder (E)
TETRISWORLDSATWE|俄罗斯方块世界|Tetris Worlds (U)
MARIO KART  AMKP|玛丽奥赛车|Mario Kart - Super Circuit (E)
ROBOPON2RINGARPJ|机甲宝贝兵２-铃铛版|Robot Ponkottsu 2 - Ring Version (J)
ROBOPON2CROSACVJ|机甲宝贝兵２-十字版|Robot Ponkottsu 2 - Cross Version (J)
NFLBLITZ2002ABZE|NFL美式足球大作战2002|NFL Blitz 20-02 (U)
GENSOU-CARD1AGKJ|幻想水浒传-卡片传说|Gensou Suikoden - Card Stories (J)
ESPN XG SK8BAXSE|ＥＳＰＮＸ游戏滑板|ESPN X-Games Skateboarding (U)
SRWA        ASRJ|超级机器人大战Ａ|Super Robot Taisen A (J)
DREAMSCHEME ARKE|动力火箭滑板-梦之计划|Rocket Power - Dream Scheme (UE)
KLONOA      AKLE|风之少年-传说的星之徽章|Klonoa - Empire of Dreams (U)
JP3PARKBUILDAJ3E|侏罗纪公园３-公园建造者|Jurassic Park III - Park Builder (U)
SPIDERMAN MMASEE|蜘蛛人-未知的威胁|Spider-Man - Mysterio's Menace (UE)
CAESARPALACEACPE|赌城|Caesars Palace Advance - Millennium Gold Edition (UE)
FO9DG01A    AF9J|专业棒球卡游戏-九局战场|Field of Nine - Digital Edition 2001 (J)
BACKTRACK   ABKE|星战总部|BackTrack (UE)
MORITASHOGI AMSJ|森田将棋|Morita Shougi Advance (J)
CASTLECAPERSARGE|小淘气-城堡冒险|Rugrats - Castle Capers (U)
PRTF        APRE|金刚战士-时空大作战|Power Rangers - Time Force (U)
Z.O.E 2173  AZEJ|Z.O.E星域毁灭者2173-圣约|Z.O.E. 2173 - Testament (J)
LADY SIA    ALDP|女神战士-西雅|Lady Sia (E)
HH MLB 2002 ASSE|火热职业联盟棒球2002|High Heat Major League Baseball 2002 (UE)
XMENROA     AXME|Ｘ战警-启示录|X-Men - Reign of Apocalypse (UE)
DLDEESASTER ADLE|德克斯特的实验室|Dexter's Laboratory - Deesaster Strikes! (U)
MX 2002     A2XE|ＭＸ２００２未来机车赛|MX 2002 featuring Ricky Carmichael (UE)
FINAL FIGHT AFFE|快打旋风|Final Fight One (U)
NOBUNAGA    ANBJ|信长异闻|Nobunaga no Yabou (J)
LEGO BIONICLALBE|乐高荒岛探险|LEGO Bionicle (U)
LEGO ISLAND AL2E|乐高积木岛２|LEGO Island 2 - The Brickster's Revenge (U)
KIKIKAIKAIGAAKIJ|奇奇怪界|Kiki Kaikai Advance (J)
SNOOD       ASQE|怪投射波|Snood (U)
SIFKBASEBALLAKBE|儿童运动画刊-棒球|Sports Illustrated for Kids - Baseball (U)
HATENASATENAAHSJ|机智解谜|Hatena Satena (J)
CHIMP CHASE AWTE|狂野丛林-猎杀黑猩猩|Wild Thornberrys, The - Chimp Chase (U)
SCOOBY CYBERASDE|史酷比鬼屋历险|Scooby-Doo and the Cyber Chase (U)
SIFKFOOTBALLAKFE|儿童运动画刊-美式足球|Sports Illustrated for Kids - Football (U)
BOXEM       ABOE|火热拳击|Boxing Fever (UE)
GYAKUTEN_SAIASBJ|逆转裁判|Gyakuten Saiban (J)
LEGO ISLAND AL2P|乐高积木岛２|LEGO Island 2 - The Brickster's Revenge (E)
LADY SIA    ALDE|女神战士-西雅|Lady Sia (U)
MINNADE PUYOAPYJ|魔法气泡大会战|Minna de Puyo Puyo (J)
TOTAL SOCCERATUP|史蒂芬.甲尔德-足球2000|Total Soccer (E)
DENKIBLOCKS!ADBP|电击方块|Denki Blocks! (E)
PREHISTO MANAPHE|摩登原始人|Prehistorik Man (UE)
K/TMIRACLEFAAKTJ|凯蒂猫游戏精选-流行创造者|Hello Kitty Collection - Miracle Fashion Maker (J)
ESL_SOCCER  AELP|欧洲超级联盟足球|European Super League (E)
PHALANX     APXJ|银河战机|Phalanx - The Enforce Fighter A-144 (J)
NAKAYOSHI-KRAKPJ|友情麻将|Nakayoshi Mahjong - Kaburiichi (J)
HAMSTAR2    AHBJ|仓鼠物语２|Hamster Monogatari 2 GBA (J)
ESPN XG SK8BAXSJ|ＥＳＰＮＸ游戏滑板|ESPN X-Games Skateboarding (J)
LEGO BIONICLALBP|乐高荒岛探险|LEGO Bionicle (E)
MONSTERS,INCAMXE|怪兽电力公司|Monsters, Inc. (UE)
AGB-DOOM    ADME|毁灭战士|Doom (UE)
YAKUMAN     AYAJ|随身对局-役满|Dokodemo Taikyoku - Yakuman Advance (J)
TANG TANG   ATAP|轰炸所罗门|Tang Tang (E)
LUCKY LUKE WALLP|幸运枪手路克-通缉犯|Lucky Luke - Wanted! (E)
SPYRO       ASYP|宝贝龙2-火焰季节|Spyro - Season of Ice (E)
SPYRO       ASYE|宝贝龙2-火焰季节|Spyro - Season of Ice (U)
BATMAN-VENGEABTE|蝙蝠侠之复仇|Batman - Vengeance (U)
SSF2TREVIVALAXRP|超级街霸ＩＩＸ-挑战者|Super Street Fighter II Turbo - Revival (E)
KAOTHEKANGARAKKE|小小袋鼠闯天关|Kao the Kangaroo (U)
WWF_ROAD_WM AWFE|ＷＷＦ摔角之路|WWF - Road to Wrestlemania (UE)
MEGAMAN_BN  AREE|洛克人ＥＸＥ-网路战斗|Megaman Battle Network (U)
GADGETRACERSAQAE|迷你赛车(可爱赛车)|Gadget Racers (U)
GRADIUSADVANAGAP|沙罗曼蛇|Gradius Advance (E)
MMBLAST     AMLE|Ｍ＆Ｍ＇ｓ巧克力旋风|M&M's Blast! (U)
WARIOLANDE  AWAE|瓦里奥４|Wario Land 4 (UE)
HIKARUNOGO  AHKJ|棋魂２|Hikaru no Go (J)
Golden_Sun_AAGSE|黄金的太阳-开启的封印|Golden Sun (UE)
DONALD DUCK ADKP|唐老鸭|Donald Duck Advance (E)
HARRY POTTERAHRE|哈利波特-神秘的魔法石|Harry Potter and the Sorcerer's Stone (UE)
BATMAN-VENGEABTP|蝙蝠侠之复仇|Batman - Vengeance (E)
JACKIECHANDHAJCE|成龙冒险-黑手党传说|Jackie Chan Adventures - Legend of the Darkhand (UE)
ALIENATORS  AEVE|进化特区|Alienators - Evolution Continues (UE)
SBSP SS     ASPE|超级海绵-巴伯|SpongeBob SquarePants - SuperSponge (U)
JIMMYNEUTRONAJNE|天才男孩-吉米|Jimmy Neutron - Boy Genius (U)
INSPECTOR GAAIGP|Ｇ型神探-进化任务|Inspector Gadget - Advance Mission (E)
TWEETY MAGICATME|金丝雀舞会|Tweety and the Magic Gems (U)
JEDIPOWERBATASWE|星际大战首部曲-绝地武士|Star Wars - Jedi Power Battles (U)
MIDNIGHTCLUBAMQE|午夜俱乐部-湾岸街头赛车|Midnight Club - Street Racing (U)
MH PRO BMX  AHOE|马特.霍夫曼-专业特技脚踏车|Mat Hoffman's Pro BMX (UE)
RAZOR FREESTARFE|劲爆滑板车|Razor Freestyle Scooter (U)
BUSTAMOVEGBAABMP|超级泡泡龙射波|Super Bust-A-Move (E)
DOKAPON     ADQE|多卡波王国-Ｑ怪兽猎人|Dokapon (U)
I.S.S. AGB  AISP|国际超级明星足球|International Superstar Soccer (E)
ATLANTIS    ATLX|失落的帝国-亚特兰提斯|Atlantis - The Lost Empire (E)
4V4 ARASHI  A4VJ|友情足球-４Ｖ４斗球儿|Yuujou no Victory Goal 4v4 Arashi - Get the Goal!! (J)
NANCYDREWMHMANDE|南茜.德鲁-鬼屋里的讯息|Nancy Drew - Message in a Haunted Mansion (U)
PPG MOJOGOGOAPTE|飞天小女警-魔人啾啾|Powerpuff Girls, The - Mojo Jojo A-Go-Go (U)
MADDEN NFL02A2ME|约翰马吨美式足球2002|Madden NFL 2002 (U)
FROG: TEMPLEAFRE|青蛙大冒险-蛙之殿堂|Frogger's Adventures - Temple of the Frog (U)
GET PHAT!   AGBE|无规则-街头滑板小子|No Rules - Get Phat (UE)
DISNEYSEA   ADEJ|东京迪斯尼大进击-海洋馆篇|Adventure of Tokyo Disney Sea (J)
DAVIDBECKHAMABQP|大卫碧咸足球|David Beckham Soccer (E)
TETRISWORLDSATWX|俄罗斯方块世界|Tetris Worlds (E)
RAMPPUZZLEATARXE|毁灭金刚方块|Rampage - Puzzle Attack (UE)
MGAH        AM3E|米德威怀旧大型电玩４合一|Midway's Greatest Arcade Hits (UE)
JP3ISLANDATTAJQE|侏罗纪公园３-动作版|Jurassic Park III - Island Attack (U)
SPUER DODGE ADFP|爆热躲避球|Super Dodge Ball Advance (E)
LEGO RACERS ALRE|乐高赛车２|LEGO Racers 2 (U)
ESPN FISHNG1AMGE|ESPN户外运动-巴斯钓鱼2002|ESPN Great Outdoor Games - Bass 2002 (U)
ECKS VSE SEVAESE|艾克斯对塞弗|Ecks vs Sever (U)
HOTWHEELS BRAHWE|无敌风火轮赛车|Hot Wheels - Burnin' Rubber (U)
MECH PLATOONAKGP|机械化军队|Mech Platoon (E)
PHALANX     APXP|银河战机|Phalanx - The Enforce Fighter A-144 (E)
ETTHEEXTRAT AETE|外星人|E.T. - The Extra-Terrestrial (U)
DAVE MIRRA FAX2E|达夫米拉特技脚踏车２|Dave Mirra Freestyle BMX 2 (U)
SHAUNPALMER1ASCE|夏恩.派蒙的专业滑雪板|Shaun Palmer's Pro Snowboarder (UE)
PRTF        APRD|金刚战士-时空大作战|Power Rangers - Time Force (G)
SANGOKUSHI  ASXJ|三国志|Sangokushi (J)
PLANETOFAPESAYNP|星球怪物|Planet of the Apes (E)
ROBOT WARS AARWP|机器人竞技场-进化毁灭|Robot Wars - Advanced Destruction (E)
CRUISN VELOCACFE|劲速狂飙|Cruis'n Velocity (UE)
TOMJERRYRINGATJE|汤姆与杰瑞-魔法铃铛|Tom and Jerry - The Magic Ring (U)
MONSRANCHERAAMFE|怪兽农场|Monster Rancher Advance (U)
IK ADVANCED AIKP|国际空手道大赛|International Karate Advanced (E)
DAISENRYAKU ADSJ|Daisenryaku(J)|Daisenryaku for Game Boy Advance (J)
GRADIUSGALAXAGAE|沙罗曼蛇|Gradius Galaxies (U)
EZ-TALK     A22J|简单说英语|EZ-Talk - Shokyuu Hen 1 (J)
EZ-TALK     A23J|简单说英语|EZ-Talk - Shokyuu Hen 2 (J)
ARMY MEN OG AMEE|玩具兵大战-绿色军事行动|Army Men - Operation Green (UE)
DRIVEN      ADVE|生死极速|Driven (U)
MH PRO BMX  AHOX|马特.霍夫曼-专业特技脚踏车|Mat Hoffman's Pro BMX (E)
BUSTAMOVEGBAABME|超级泡泡龙射波|Super Bust-A-Move (U)
COLUMNS CROWACGP|宝石方块|Columns Crown (E)
JACKIECHANDHAJCF|成龙冒险-黑手党传说|Aventures de Jackie Chan, Les - La Legende de la Main Noire (F)
MAGICAL VACAAMVJ|魔法假期|Magical Vacation (J)
ADVANCE RALLAR7J|越野房车赛|Advance Rally (J)
GAKKOAGB-1  AYSJ|模拟学校|Gakkou wo Tsukurou!! Advance (J)
MONSTERFARMAAMFJ|怪兽农场|Monster Farm Advance (J)
THUNDERBIRDSATNP|雷鸟-国际救援组织|Thunderbirds - International Rescue (E)
SHAUNPALMER1ASCD|夏恩.派蒙的专业滑雪板|Shaun Palmer's Pro Snowboarder (G)
W.A.SOCCER_WAASJ|世界足球－迈向胜利之路|World Advance Soccer - Shouri heno Michi (J)
NAMCOMUSEUM ANMJ|南梦宫博物馆|Namco Museum (J)
PLANET MNSTRAPME|星球怪物|Planet Monsters (U)
SUPER MARIOBAA2J|超级玛丽奥２|Super Mario Advance 2 (J)
ROCKMAN_EXE2AE2J|洛克人ＥＸＥ２|Battle Network Rockman EXE 2 (J)
BOF1        ABFE|龙战士|Breath of Fire (U)
COLUMNSCROWNACGJ|宝石方块|Columns Crown (J)
MK_ADVANCE  AM5E|真人快打|Mortal Kombat Advance (U)
W.S.POCKET  AJWJ|实况世界足球口袋版|Jikkyou World Soccer Pocket (J)
MEGAMANEXEBNAREP|洛克人ＥＸＥ-网路战斗|Megaman Battle Network (E)
AMERICA_BASSAABE|美国巴斯钓鱼挑战赛|American Bass Challenge (U)
SONICADVANCEASOJ|索尼克大冒险|Sonic Advance (J)
KINBANGBA2  AK5J|筋肉番付２-奇迹之完全制霸|Kinniku Banzuke - Kimero! Kiseki no Kanzen Seiha (J)
BAYBLADE_1  AHEJ|爆转陀螺王-激斗赛|Bakuten Shoot Beyblade - Gekitou! Saikyou Blader (J)
FSTONES BTIBAFSE|石头族乐园-岩床上的大麻烦|Flintstones, The - Big Trouble in Bedrock (U)
TEKKEN      ATKJ|铁拳|Tekken Advance (J)
BOF2        AB2J|龙战士２-使命之子|Breath of Fire II - Shimei no Ko (J)
TORUNEKO2   AT2J|特鲁尼克大冒险2|Torneco no Daibouken 2 Advance - Fushigi no Dungeon (J)
ZOIDSSAGA   ATZJ|机兽新世纪2|Zoids Saga (J)
RECCATHEGAMEARHJ|烈火之炎|Recca no Honoo - The Game (J)
ESPN XG SNOWAWXJ|ESPN冬季运动会-滑雪板2002|ESPN Winter X-Games Snowboarding 2002 (J)
KCEJDM6EX2  AY6J|游戏王６|Yu-Gi-Oh! - Duel Monsters 6 Expert 2 (J)
ADVANCEWARSPAWRP|大战略|Advance Wars (E)
KAOTHEKANGARAKKP|小小袋鼠闯天关|Kao the Kangaroo (E)
KINGOFEXNEOBAKOJ|格斗天王ＥＸ|King of Fighters EX, The - NeoBlood (J)
ANGELICLAYERAALJ|机动天使(天使领域)|Kidou Tenshi Angelic Layer - Misaki to Yume no Tenshi-tachi (J)
SANSARA 1X2 ASNJ|育龙战记１ｘ２|Sansara Naga 1x2 (J)
EZ-TALK     A24J|简单说英语|EZ-Talk - Shokyuu Hen 3 (J)
EZ-TALK     A25J|简单说英语|EZ-Talk - Shokyuu Hen 4 (J)
MECH PLATOONAKGE|机械化军队|Mech Platoon (U)
DARK ARENA  ADAE|暗黑竞技场|Dark Arena (UE)
CREATURESAGBACTX|造物计划|Creatures (E)
PACMANCOLLE APCJ|吃豆子全集|Pac-Man Collection (J)
FSTONES BTIBAFSP|石头族乐园-岩床上的大麻烦|Flintstones, The - Big Trouble in Bedrock (E)
SNAPKIDS    AEAJ|摄影小子|Snap Kid's (J)
ASTERIX & OBAOBP|美丽新世界|Asterix & Obelix - Bash Them All! (E)
ESPN XG SNOWAWXE|ESPN冬季运动会-滑雪板2002|ESPN Winter X-Games Snowboarding 2002 (U)
GGXAE       AGXJ|罪恶克星Ｘ|Guilty Gear X - Advance Edition (J)
GRADIUSGENERAGAJ|沙罗曼蛇|Gradius Generation (J)
TOMATO_ADV  AGLJ|蕃茄世界冒险记|Tomato Adventure (J)
HYPER_SPORTSAWIJ|超级运动家2002冬季版|Hyper Sports 2002 Winter (J)
TEKKEN      ATKE|铁拳|Tekken Advance (U)
WINTERSPORTSAWIE|ESPN盐湖城冬季奥运2002|ESPN International Winter Sports 2002 (U)
SALT LAKE 20AS5E|ESPN国际冬季运动会|Salt Lake 2002 (U)
PACMANCOLLE APCP|吃豆子全集|Pac-Man Collection (E)
WIZ SUMMONERAWZJ|辟邪除妖-招唤者|Wizardry Summoner (J)
SHANGHAI ADVASVJ|上海|Shanghai Advance (J)
SONICADVANCEASOE|索尼克大冒险|Sonic Advance (U)
GURANBO     AIBJ|格兰宝大作战(钢铁宝贝)|Guranbo (J)
JONNYMOSELEYAJME|强尼.摩斯立之疯狂滑雪|Jonny Moseley Mad Trix (UE)
PUYO POP    APYE|亿万长者游戏|Puyo Pop (U)
OKUMAN 01   AOKJ|魔法气泡大会战|Okumanchouja Game - Nottori Daisakusen! (J)
PINKEY TOWN APNJ|粉红猴城|Pinky Monkey Town (J)
HARRY POTTERAHRJ|哈利波特-神秘的魔法石|Harry Potter to Kenja no Ishi (J)
SUPER MARIOBAA2E|超级玛丽奥２|Super Mario Advance 2 - Super Mario World (UA)
JP3DINOATTACAJQP|侏罗纪公园３-动作版|Jurassic Park III - Dino Attack (E)
ADVANCEWARS AWRE|大战争|Advance Wars (U)
COLUMNSCROWNACGE|宝石方块|Columns Crown (U)
WTATOUR     ACIJ|超真实女子网球赛-口袋版|WTA Tour Tennis Pocket (J)
DAVE MIRRA FAX2P|达夫米拉特技脚踏车２|Dave Mirra Freestyle BMX 2 (E)
PETERPAN RTNAPPE|小飞侠-梦不落帝国|Peter Pan - Return to Neverland (U)
GOLDEN_SUN_AAGSF|黄金的太阳-开启的封印|Golden Sun (F)
ESPN FISHNG2AMGP|ESPN户外运动-巴斯钓鱼2002|ESPN Great Outdoor Games - Bass Tournament (E)
EZ-TALK     A26J|简单说英语|EZ-Talk - Shokyuu Hen 5 (J)[b]
EZ-TALK     A27J|简单说英语|EZ-Talk - Shokyuu Hen 6 (J)
NBA JAM 2002ABNE|劲爆ＮＢＡ２００２|NBA Jam 2002 (UE)
TSUBASA 2001AKYJ|天使之翼-荣光之轨迹|Captain Tsubasa - Eikou no Kiseki (J)
POCKET MUSICAP9P|无敌风火轮赛车|Pocket Music (E)
VIRTKASPAROVAVKP|口袋音乐|Virtual Kasparov (E)
BURNIN RUBBEAHWP|虚拟西洋棋手|Hot Wheels - Burnin' Rubber (E)
TOMJERRYRINTATJP|星球怪物|Tom and Jerry - The Magic Ring (E)
PLANET MNSTRAPMP|汤姆与杰瑞－魔法铃铛|Planet Monsters (E)
JIMMY NEUTROAJNX|天才男孩－吉米|Jimmy Neutron - Boy Genius (E)
CHUCHU ROCKEACRP|啾啾火箭队|Chu Chu Rocket! (E)
MOTOGP      AM4P|ＧＰ摩托车赛|Moto GP (E)
B-MAX2BOM   AMHJ|炸弹人MAX2－炸弹人版|Bomberman Max 2 - Bomberman Version (J)
CRASH       ACQP|古惑狼２|Crash Bandicoot XS (E)
GOEMONNEW   AGNJ|伍佑卫门新时代出动!|Goemon - New Age Shutsudou! (J)[b]
JPOCKET2    AJ2J|口袋Ｊ联盟足球２|J.League Pocket 2 (J)
LANDBEFORETIALAP|麦可.泰森拳击|Land Before Time, The (E)
TYSON BOXINGAM9P|史前之岛|Mike Tyson Boxing (E)
INSPECTOR GAAIGE|银河战机|Inspector Gadget - Advance Mission (U)
PHALANX     APXE|Ｇ型神探-进化任务|Phalanx - The Enforce Fighter A-144 (U)
Z.O.E USA   AZEE|美国鼠谭|Zone of the Enders - The Fist of Mars (U)
AMERICANTAILAFGP|星域毁灭者|An American Tail - Fievel's Gold Rush (E)
BLACK BLACK AWEJ|魔笛师传说|Black Black - Bura Bura (J)
SSF2TREVIVALAXRE|超级街霸ＩＩＸ-挑战者|Super Street Fighter II Turbo - Revival (U)
GOASTHOUSE24AUYJ|幽灵屋敷之２４小时|Yuureiyashiki no Nijuuyojikan (J)
DOMOKUN     ADOJ|多摩君之不可思议的电视|Domo-kun no Fushigi Terebi (J)
Mail de CuteAMCJ|可爱邮差|Mail de Cute (J)
B-MAX2MAX   AMYJ|炸弹人ＭＡＸ２-MAX版|Bomberman Max 2 - Max Version (J)
PLANETOFAPESAYNE|星球怪物|Planet of the Apes (U)
TONY HAWK 3!AT3E|汤尼.霍克专业滑板３|Tony Hawk's Pro Skater 3 (UE)
HH MLB 2003 AHHE|火热职业联盟棒球2003|High Heat Major League Baseball 2003 (U)
NHL 2002    ANLE|美国冰上曲棍球联赛2002|NHL 2002 (U)
CASPER      ACSP|鬼马小精灵|Casper (E)
SONIC ADVANCASOP|索尼克大冒险|Sonic Advance (E)
MIBTHESERIESAMIE|ＭＩＢ星际战警|Men in Black - The Series (U)
STARWARSJEDIASWX|星际大战首部曲-绝地武士|Star Wars - Jedi Power Battles (E)
TGGT-CHAMP  ATCE|全日本ＧＴ冠军赛车|Top Gear GT Championship (U)
DISNEY'S DONAADJ|唐老鸭|Donald Duck Advance (J)
CHINMOKU-ESTAGDJ|四狂神战记外传-沉默之遗迹|Chinmoku no Iseki - Estpolis Gaiden (J)
CRASH       ACQE|古惑狼２|Crash Bandicoot - The Huge Adventure (U)
TYSON BOXINGAM6E|麦可.泰森拳击|Mike Tyson Boxing (U)
MOTOGP      AM4E|ＧＰ摩托车赛|Moto GP (U)
RAINBOWSIX-RAR6E|彩虹６号|Tom Clancy's Rainbow Six - Rogue Spear (U)
SPACE INVADEAIDE|太空侵略者|Space Invaders (UE)
SRWA        ASRJ|超级机器人大战Ａ|Super Robot Taisen A (C)(Unl)
DRIVEN AGB  ADVP|生死极速|Driven (E)
MARY KATE ANAKSE|玛莉凯特与艾希莉-愈夜愈疯狂|Mary-Kate and Ashley - Girls Night Out (U)
GURULOGI_C  AGCJ|转转方块|Guru Logic Champ (J)
DISNEY'S DONADKE|唐老鸭|Donald Duck Advance (U)
ANGELIQUE   AAGJ|安琪莉可之女王学院|Angelique (J)
PAWAPOKE4   AP4J|实况野球君４|Power Pro Kun Pocket 4 (J)
BASEBALL ADVABPE|棒球|Baseball Advance (U)
RAINBOWSIX-RAR6P|彩虹６号|Tom Clancy's Rainbow Six - Rogue Spear (E)
KCS ARCADE  AKCE|科拿米怀旧大型电玩６合一|Konami Collector's Series - Arcade Advanced (U)
MM ADVANCE  AMRE|疯狂越野摩托车|Motocross Maniacs Advance (U)
DRACULA AGB1AAMJ|恶魔城-月之轮回|Akumajou Dracula - Circle of the Moon (C)(Unl)
BROKENSWORD ABJP|断剑-圣堂武士之谜|Broken Sword - The Shadow of the Templars (E)
RAVE        ARVJ|圣石小子-光与暗的大决战２|Groove Adventure Rave - Hikari to Yami no Daikessen (J)
ICEAGE      AIAE|冰原历险记|Ice Age (U)
SHREK KART  AS4E|史瑞克沼泽赛车|Shrek - Swamp Kart Speedway (UE)
CHESSMASTER ACYP|西洋棋大师|Chessmaster (E)
GOLDEN_SUN_AAGSD|黄金的太阳-开启的封印|Golden Sun (G)
K-1POCKET_GPAKVJ|Ｋ－１口袋格斗大奖赛２|K-1 Pocket Grand Prix (J)
PUZZBOB-ADV ABMJ|超级泡泡龙射波|Super Puzzle Bobble Advance (J)
SLOT!PRO    ASFJ|宝船＆大江户樱吹雪２|Slot! Pro Advance - Takarabune & Ooedo Sakurafubuki 2 (J)
DENDOHMAJANGASMJ|西原理惠子之殿堂麻雀|Saibara Rieko no Dendou Mahjong (J)
MECH PLATOONAKGJ|机械化军队|Kikaika Guntai - Mech Platoon (J)
DIADROIDSWLDADDJ|钻甲人世界-邪恶帝国的野心|Diadroids World - Evil Teikoku no Yabou (J)
PSJUOGBA    AJUJ|实战柏青森必胜法兽王|Jissen Pachi-Slot Hisshouhou! - Juuou Advance (J)
DAI-MA-JANG AHMJ|大麻雀|Dai-Mahjong (J)
BROKENSWORD ABJE|断剑-圣堂武士之谜|Broken Sword - The Shadow of the Templars (U)
MAYA THE BEEABVP|蜜蜂玛雅-伟大的冒险|Maya the Bee - The Great Adventure (E)
FIREEMBLEM6 AFEJ|火焰纹章-封印之剑|Fire Emblem - Fuuin no Tsurugi (J)
SHINING SOULAHUJ|光明之魂|Shining Soul (J)
ATARI_ANNIVEAAVE|雅达利周年纪念游戏|Atari Anniversary Advance (U)
DANCE BEAT  ABYE|小甜甜布兰妮之舞蹈节拍|Britney's Dance Beat (U)
SCRABBLE    AQBP|拼字游戏|Scrabble (E)
GOLDEN_SUN_AAGSS|黄金的太阳-开启的封印|Golden Sun (S)
MONSTER JAM AJAE|怪物卡车大作战|Monster Jam - Maximum Destruction (U)
FILA DECATHLAFLP|十项全能|FILA Decathlon (E)
M HOUSHIN   AJOJ|魔法封神|Magical Houshin (J)
EXTREME GHOSAEGP|终极魔鬼克星|Extreme Ghostbusters - Code Ecto-1 (E)
SCORPIONKINGASZE|魔蝎大帝-大地之剑|Scorpion King, The - Sword of Osiris (U)
ISSEKIHATCHOAIEJ|一石八鸟|Isseki Hatchou - Kore 1ppon de 8shurui! (J)
PETERPAN RTNAPPP|小飞侠-梦不落帝国|Peter Pan - Return to Neverland (E)
BASS ADVANCEAABP|超级黑巴斯钓鱼|Super Black Bass Advance (E)
BOF EUR     ABFX|龙战士|Breath of Fire (E)
TTA-WACKY   AWSP|顽皮兔大冒险-古怪蛋方块|Tiny Toon Adventures - Wacky Stackers (E)
KLONOA EMPIRAKLP|风之少年-梦想帝国|Klonoa - Empire of Dreams (E)
3 STOOGES   A3TE|三个臭皮匠|Three Stooges, The (U)
XBLADEZ: INLAXIP|Ｘ旋风直排轮竞赛|X-Bladez - Inline Skater (E)
VIRTKASPAROVAVKE|虚拟西洋棋手|Virtual Kasparov (U)
AGB-P-A54J  A54J|高校受验加强系列-英语构文篇|Eigo Koubun Hen - 26 Units Shuuroku (J)
WOLF3D      AWOE|德军总部３Ｄ|Wolfenstein 3D (U)
CARDE READERPEAJ|卡片读取机|Card e-Reader (J)
LUNAR LEGENDALNJ|银河之星－露娜传奇|Lunar Legend (J)
SUPER MARIOBAA2P|超级玛丽奥２|Super Mario Advance 2 - Super Mario World (E)
BOF2        AB2E|蜘蛛人-电影版|Breath of Fire II (U)
SPIDERMAN   AKXE|龙战士２-使命之子|Spider-Man (UE)
STAR X      AS8E|行星战机Ｘ|Star X (U)
SCORPIONKINGASZP|魔蝎大帝-大地之剑|Scorpion King, The - Sword of Osiris (E)
TETRISWORLDSATWJ|俄罗斯方块世界|Tetris Worlds (J)
SPIDERMAN MMASEJ|蜘蛛人-未知的威胁|Spider-Man - Mysterio no Kyoui (J)
BLENDER BROSABRE|超连体兄弟|Blender Bros. (U)
ROCKMAN ZEROARZJ|洛克人ＺＥＲＯ|Rockman Zero (J)
ADVANCE GT2 A2GJ|ＧＴＡ赛车２|Advance GT2 (J)
UI IRE      AEWJ|胜利１１人世界足球|Ui-Ire - World Soccer Winning Eleven (J)
KCEJ TPRI01 ATIJ|网球王子|Tennis no Ouji-sama - Genius Boys Academy (J)[b]
INIDAS      AINJ|头文字Ｄ-另一个故事|Initial D - Another Stage (J)
PENNY RACERSAQAP|迷你可爱赛车|Penny Racers (E)
COOKIE PIE  ABGJ|甜蜜饼干派|Sweet Cookie Pie (J)
DINOTOPIA   AD3E|时空英豪|Dinotopia - The Timestone Pirates (UE)
HAPPYPANECHUKHPJ|快乐转盘|Koro Koro Puzzle - Happy Panechu! (J)
KUROHIGEGOLFAGOJ|黑胡子之大家来打高尔夫|Kurohige no Golf Shiyouyo (J)
TELEFANG2POWATPJ|携带电兽２力量版|Keitai Denjuu Telefang 2 - Power (J)
TELEFANG2SPEATSJ|携带电兽２速度版|Keitai Denjuu Telefang 2 - Speed (J)
KAERU B BACKAKDJ|青蛙回家|Kaeru B Back (J)
DESERTSTRIKEADIE|全美明星棒球２００３|Desert Strike Advance (U)
ALLSTAR 2003AA3E|沙漠风暴|All-Star Baseball 2003 (U)
NASCAR HEAT ANHE|云斯顿赛车２００２|NASCAR Heat 2002 (U)
F-SOCCER2002AFMJ|立体足球２００２|Formation Soccer 2002 (J)
DORA WALKER ADPJ|小叮当冒险盘戏|Doraemon - Dokodemo Walker (J)
ANIMALMANIA1AANJ|动物通可爱占卜|Animal Mania - Dokidoki Aishou Check (J)
KIJUTSU     AG2J|神之记述-邪恶之眼的幻影|Kami no Kijutsu - Illusion of the Evil Eyes (J)
KAWANUSI5   AN5J|川钓太郎５|Kawa no Nushi Tsuri 5 - Fushigi no Mori Kara (J)
CARBATTLERGOACBJ|激斗!遥控车战士ＧＯ!|Gekitou! Car Battler Go!! (J)
TACTICSOGRE ATOE|皇家骑士团外传|Tactics Ogre - The Knight of Lodis (U)
TIGER WOODS AT5E|老虎伍兹PGA高尔夫球巡回赛|Tiger Woods PGA Tour Golf (UE)
DBZ LGCYGOKUALGE|七龙珠Ｚ--悟空传奇|Dragon Ball Z - The Legacy of Goku (U)
SHEEP       AHIJ|绵羊之心|Hitsuji no Kimochi (J)
LIFE_ADVANCEAZGJ|人生游戏|Jinsei Game Advance (J)
SPY HUNTER  AHNE|间谍猎人|SpyHunter (U)
DAVIS CUP   AD6P|戴维斯杯网球公开赛|Davis Cup (E)
TS MANAGER  ATFP|冠军足球经理|Total Soccer Manager (E)
DOWNFORCEAGBADWE|Ｆ１重装赛车|Downforce (UE)
YOUKAIDOU   AFUJ|妖怪道|Youkaidou (J)
BASEBALL2003ACKE|儿童庭院空地棒球|Backyard Baseball (U)
GOLDEN_SUN_AAGSI|黄金的太阳-开启的封印|Golden Sun (I)
GT-CHAMP    ATCX|全日本ＧＴ冠军赛车|GT Championship (E)
SHEEP       AEPP|绵羊之心|Sheep (E)
NGT / ROLANDATXP|法国网球公开赛2002-次世代网球|Next Generation Tennis (E)
DBZCARDGAME1ADZE|七龙珠Ｚ-卡片收集游戏|Dragon Ball Z - Collectible Card Game (U)
HAMUTARO3   AH3J|哈姆太郎３|Tottoko Hamutarou 3 - Love Love Daibouken Dechu (J)
STAR WARS EPAS2E|星际大战-二部曲-复制人全面进攻|Star Wars Episode II - Attack of the Clones (U)
SPIRIT: STALAC6E|小马王|Spirit - Stallion of the Cimarron - Search for Homeland (U)
EARTHWORM J2AJ4E|蚯蚓吉姆２|Earthworm Jim 2 (U)
MAX2BLUEADV AMHE|炸弹人ＭＡＸ２-蓝版|Bomberman Max 2 - Blue Advance (U)
MAX2-REDADV AMYE|炸弹人ＭＡＸ２-红版|Bomberman Max 2 - Red Advance (U)
FROGQST     AFQE|青蛙大冒险|Frogger Advance - The Great Quest (U)
MUPPET PINBAAMWE|芝麻街弹珠台|Muppet Pinball Mayhem (U)
HEY ARNOLD! AAEE|嗨！阿诺德-电影版|Hey Arnold! - The Movie (U)
SPIDER-MAN  AKXF|蜘蛛人-电影版|Spider-Man (F)
PUNCH KING  APGE|击倒王|Punch King - Arcade Boxing (U)
GREMLINS    AGGP|魔怪小精灵|Gremlins - Stripe vs Gizmo (E)
CASTLEVANIA1ACHJ|恶魔城-白夜协奏曲|Castlevania - Byakuya no Concerto (J)
ZOO CUBE    ANCE|立体旋转方块|ZooCube (U)
LILO AND STIALTE|星际宝贝|Lilo & Stitch (U)
SCOOBYMOVIEEAP8E|史酷比鬼屋历险-真人照片版|Scooby-Doo (U)
Z.O.E EU    AZEP|星域毁灭者|Zone of the Enders - The Fist of Mars (E)
SCOOBY CYBERASDX|史酷比鬼屋历险|Scooby-Doo and the Cyber Chase (E)
RIPPING GAMEARDE|顶尖同伴|Ripping Friends, The (UE)
TONY HAWK 3!AT3F|汤尼.霍克专业滑板３|Tony Hawk's Pro Skater 3 (F)
MEGAMAN_EXE2AE2E|洛克人ＥＸＥ-网路战斗２|Megaman Battle Network 2 (U)
KCS ARCADE  AKCJ|科拿米怀旧大型电玩６合一|Konami Arcade Game Collection (J)
MM ADVANCE  AMRJ|疯狂越野摩托车|Motocross Maniacs Advance (J)
ICE AGE     AIAP|冰原历险记|Ice Age (E)
NICKTOONSRACANQE|尼克卡通赛车|Nicktoons Racing (U)
V-RALLY 3   AVRP|Ｖ拉力越野赛车３|V-Rally 3 (E)
DANCE BEAT  ABYX|小甜甜布兰妮之舞蹈节拍|Britney's Dance Beat (E)
ROBOPON2RINGARPE|机甲宝贝兵２-铃铛版|Robopon 2 - Ring Version (U)
ROBOPON2CROSACVE|机甲宝贝兵２-十字版|Robopon 2 - Cross Version (U)
F TENNIS    AATJ|家庭网球|Family Tennis Advance (J)
DROOPYS TENNAD7P|杜皮狗之网球公开赛|Droopy's Tennis Open (E)[b]
CT SPECIAL FAC7P|ＣＴ特种部队|CT Special Forces (E)
PINBALL DEADAPDE|死亡弹珠台|Pinball of the Dead, The (U)
GT ADVANCE 2AGWE|ＧＴＡ赛车进化版２|GT Advance 2 - Rally Racing (U)
STAR X      AS8P|行星战机Ｘ|Star X (E)
SOCCER MANIAALSE|乐高足球|LEGO Soccer Mania (UE)
MM ADVANCE  AMRP|疯狂越野摩托车|Maniac Racers Advance (E)
STAR WARS EPAS2X|星际大战-二部曲-复制人全面进攻|Star Wars Episode II - Attack of the Clones (E)
DOKAPON     ADQP|多卡波王国-Ｑ怪兽猎人|Dokapon (E)
WTATOUR     ATEP|超真实女子网球赛-口袋版|Pro Tennis WTA Tour (E)
LILO AND STIALTP|星际宝贝|Lilo & Stitch (E)
OUGONTAIYO_BAGFJ|黄金的太阳２-失落的时代|Ougon no Taiyou - Ushinawareshi Toki (J)
AEROACROBATXAAOE|蝙蝠小子|Aero the Acro-Bat - Rascal Rival Revenge (U)
MEDABOTS RKSAK9E|金属机器人战记ＡＸ-六书版|Medabots AX - Rokusho Version (U)
MEDABOTS MTBAK8E|金属机器人战记ＡＸ-蓝蜂版|Medabots AX - Metabee Version (U)
YUGIOU DM7  AY7J|游戏王７-决斗都市传说|Yu-Gi-Oh! - Duel Monsters 7 - Kettou Toshi Densetsu (J)
PINBALL DEADAZOJ|死亡弹珠台|Pinball of the Dead, The (J)
BAYBLADE_2  AB8J|爆转陀螺王２(战斗陀螺２)|Beyblade - Ikuze! Bakutou! Chou Jiryoku Battle!! (J)
PINBALL CHALAPLP|挑战弹珠台-高级版|Pinball Challenge Deluxe (E)
CHESSMASTER ACYF|西洋棋大师|Chessmaster (F)
STUARTLITTLEASLE|一家之鼠２|Stuart Little 2 (UE)
MONSTERGATE1ANFJ|怪兽之门|Monster Gate (J)
KONG        AKQP|金刚之旅|Kong - The Animated Series (E)
TOPGUN FSTA ATGE|捍卫战士|Top Gun - Firestorm Advance (UE)
DS_SOCCER   A6DJ|迪斯尼全明星足球|Disney Sports - Soccer (J)
CHOHMAKAI R ACJJ|超魔界村Ｒ|Chou Makaimura R (J)
FINAL FP    AFWJ|终极火爆摔角-梦之团体运营|Final Fire Pro Wrestling - Yume no Dantai Unei! (J)
BUBBLEBOBBLEA2BJ|泡泡龙-旧版＆新版|Bubble Bobble - Old & New (J)
HIKARUNOGO2 AKEJ|棋魂２|Hikaru no Go 2 (J)
TTABBD      ATTP|顽皮兔大冒险-巴斯特的恶梦|Tiny Toon Adventures - Buster's Bad Dream (E)
MOORHEN 3   AU3P|红冠水鸡３-猎鸡人|Moorhen 3 - The Chicken Chase! (E)
ROBO GX     ARJJ|组合机器人ＧＸ|Custom Robo GX (J)
BOF2        AB2P|龙战士２-使命之子|Breath of Fire II (E)
SHAMAN KING2AKAJ|通灵童子-超占事略决２|Shaman King Card Game - Chou Senjiryakketsu 2 (J)
GHOSTTRAP   AGVJ|幽灵陷阱|Ghost Trap (J)
ANTZ RACING ANZP|小蚁雄兵之终极赛车|Antz - Extreme Racing (E)
SRWR        AJ9J|超级机器人大战Ｒ|Super Robot Taisen R (J)
ETTHEEXTRAT AETP|外星人|E.T. - The Extra-Terrestrial (E)
KCS ARCADE  AKCP|科拿米怀旧大型电玩６合一|Konami Collector's Series - Arcade Classics (E)
XXX         AX3E|限制级战警|xXx (UE)
CHIMP CHASE AWTF|狂野丛林-猎杀黑猩猩|Famille Delajungle, La - A la Poursuite de Darwin (F)
HOT POTATO  AHPX|热洋芋片|Hot Potato! (E)
ESPN XG SK8BAXSP|ＥＳＰＮＸ游戏滑板|ESPN X-Games Skateboarding (E)
PINO & PHOE AP6J|皮诺比与菲比的大冒险|Pinobee & Phoebee (J)
FUSHIGIANGE AFAJ|女王学院-个人携带版|Fushigi no Kuni no Angelique (J)
HOTWHEELS BRAHWJ|无敌风火轮赛车|Hot Wheels Advance (J)
HIGEJINTORI AKUJ|黑胡子转转碰碰球|Kurohige no Kurutto Jintori (J)
KLONOA G2   AN6J|风之少年２|Kaze no Klonoa G2 - Dream Champ Tournament (J)
SPACE INV EXAIDJ|太空侵略者ＥＸ|Space Invaders EX (J)
MEDABOTS_RKSAK9P|金属机器人战记ＡＸ-六书版|Medabots AX - Rokusho Version (E)
MANIC MINER A4MP|疯狂矿工|Manic Miner (E)
KAMAITACHI  AKZJ|恐怖惊魂夜|Kamaitachi no Yoru Advance (J)
SANGOKUSHI  ASXJ|三国志|Sangokushi (C)(Unl)
GREATESTNINEAG9J|最强九人组棒球|Greatest Nine (J)
VMASTERCROSSAVMJ|Ｖ怪兽卡斗士|V-Master Cross (J)
KINGOFEXNEOBAKOE|格斗天王ＥＸ|King of Fighters EX, The - NeoBlood (U)[b]
CUBIX_GBA   ACXE|新机器人大战-狂冲猛撞|Cubix - Robots for Everyone - Clash 'N Bash (U)
MIC&MIN MA  A3MJ|米奇与米妮的奇妙冒险|Mickey to Minnie no Magical Quest (J)
ROCK&FORTE  AFCJ|洛克人与佛鲁迪|Rockman & Forte (J)
HEY!ARNOLD! AAEE|嗨！阿诺德|Hey Arnold! - The Movie (E)[b]
ZOO CUBE    ANCP|立体旋转方块|ZooCube (E)
URBANYETI   AYIE|都市野蛮人|Urban Yeti! (UE)
MADDEN NFL03ANJE|约翰马吨美式足球２００３|Madden NFL 2003 (U)
MIC&MIN MA  A3ME|米奇与米妮的奇妙冒险|Magical Quest Starring Mickey & Minnie (U)
SPYKIDSCHALLA2KE|小鬼大贱谍|Spy Kids Challenger (U)
NFL BLITZ2K3ANKE|NFL美式足球闪电大作战2003|NFL Blitz 20-03 (U)
COMBATCQ    AQCJ|可爱战车Ｑ|Combat Choro Q - Advance Daisakusen (J)
CRASH       ACUJ|古惑狼２|Crash Bandicoot Advance (J)
FAMISTA     AN7J|科拿姆棒球|Famista Advance (J)
DUKE NUKEM AAD9E|毁灭公爵|Duke Nukem Advance (U)
MH PRO2 AGB AH2E|马特.霍夫曼-专业特技脚踏车2|Mat Hoffman's Pro BMX 2 (UE)
VIP         AVPP|反恐精英之保护ＶＩＰ|V.I.P. (E)
MONSTERFORCEAM8E|怪兽力量|Monster Force (U)
MINIMONI    AHCJ|迷你早安-落在山脊上的星星|Minimoni - Mika no Happy Morning Chatty (J)
PR_WILDFORCEAPWE|金刚战士-荒野大作战|Power Rangers - Wild Force (UE)
TETSUYA     ATYJ|胜负师传说-哲也-苏醒传说|Gambler Densetsu Tetsuya - Yomigaeru Densetsu (J)
ATV QUAD POWAQRE|海滩车动力竞速|ATV Quad Power Racing (UE)
MR.DRILLER AAD5J|爆钻小英雄ＡＣＥ|Mr. Driller A - Fushigi na Pacteria (J)[b]
YAKUTUKUADV ALMJ|模拟职棒|Pro Yakyuu Team wo Tsukurou! Advance (J)
TUROK EVOL  AT4P|恐龙猎人进化版|Turok Evolution (E)
MONSTERS    AMXJ|怪兽电力公司|Monsters, Inc. (J)
MUTSU       AMUJ|电子鱼|Mutsu - Water Looper Mutsu (J)
VRALLY 3    AVRJ|Ｖ拉力越野赛车３|V-Rally 3 (J)
MEDAROTGKWG AGIJ|徽章战士Ｇ-锹型虫版|Medarot G - Kuwagata Version (J)
ROCKETPOWERFARKF|动力火箭滑板-梦之计划|Rocket Power - Le Cauchemar d'Otto (F)
MONSTERS INCAMXY|怪兽电力公司|Monsters, Inc. (E)
BLACKMATRIX0AXBJ|正邪幻想史ＺＥＲＯ|Black Matrix Zero (J)
SABRINA-THE A3BE|少女魔法师|Sabrina - The Teenage Witch - Potion Commotion (U)
UKICANI     ACLJ|樱桃丸子的欢乐庆典|Sakura Momoko no UkiUki Carnival (J)
TOKYO MYUMYUAM7J|东京喵喵拼图|Hamepane - Tokyo Mew Mew (J)
CASTLECAPERSARGF|小淘气-城堡冒险|Razmoket, Les - Voler N'Est Pas Jouer (F)
AGGRESSIVE IAILE|溜冰高手|Aggressive Inline (U)
PINKY&BRAIN APIP|小小老鼠征地球-至高计划|Pinky and the Brain - The Masterplan (E)
GOGOBECKHAM!AGQP|冲吧!贝克汉母-足球岛大冒险|Go! Go! Beckham! - Adventure on Soccer Island (E)
NOBUNAGAIBUNANOJ|信长异闻|Nobunaga Ibun (J)
DINODEVICE RAAIJ|转转蛋怪兽站-红版|Gachasute! Dino Device - Red (J)
JP3 THE DNA ADNJ|侏罗纪公园３-ＤＮＡ因子|Jurassic Park III - Ushinawareta Idenshi (J)
SK8 THPS2   ATHJ|汤尼霍克专业滑板２|SK8 - Tony Hawk's Pro Skater 2 (J)
CASTLEVANIA1ACHP|恶魔城-白夜协奏曲|Castlevania - Harmony of Dissonance (E)
SAKATUKUADV AC2J|模拟Ｊ联盟足球|J.League Pro Soccer Club wo Tsukurou! Advance (J)
NICKTOONS RAANQP|尼克卡通赛车|Nicktoons Racing (E)
STAFY       ASTJ|传说的斯塔菲2|Densetsu no Stafy (J)
DS_FOOTBALL A3DJ|迪斯尼明星运动会-美式足球篇|Disney Sports - American Football (J)
DS_SKATE    A4DJ|迪斯尼明星运动会-街头滑板篇|Disney Sports - Skateboarding (J)
AGGRESSIVE IAILP|溜冰高手|Aggressive Inline (E)
BMX TRICK RAAT9E|特技越野脚踏车赛|BMX Trick Racer (U)
MBXCTH      ARQE|救火英雄|Matchbox Cross Town Heroes (U)
SILENT SCOPEAIPE|沉默狙击手|Silent Scope (U)
TIGER WOODS AT5X|老虎伍兹PGA高尔夫球巡回赛|Tiger Woods PGA Tour Golf (E)
SPEEDBALL 2 AS6P|光速足球２|Speedball 2 - Brutal Deluxe (E)
MEGAMAN ZEROAZCE|洛克人ＺＥＲＯ|Megaman Zero (UE)
COMIX ZONE  ACZP|漫画地带|Comix Zone (E)
NATURAL2 DUOAN2J|双姝情缘|Natural 2 - Duo (J)
SABRINA-THE A3BP|少女魔法师|Sabrina - The Teenage Witch - Potion Commotion (E)
SBREVENGEGBAAQ3E|超级海绵巴伯2-荷兰鬼魂的复仇|SpongeBob SquarePants - Revenge of the Flying Dutchman (UE)
SUPER MARIOCA3AE|超级玛丽奥３-耀西之岛|Super Mario Advance 3 - Yoshi's Island (U)
SUM ALL FEARAA6P|恐惧的总和|Sum of All Fears, The (E)
SUPER MARIOCA3AJ|超级玛丽奥３-耀西之岛|Super Mario Advance 3 (J)
AIRFORCEDELTAAKE|空战神鹰风暴|AirForce Delta Storm (U)
B-DASH EX   ABDE|推石小子ＥＸ|Boulder Dash EX (U)
BACKYARDFBL AYFE|儿童庭院空地美式足球|Backyard Football (U)
GROOVY GAMESAVBE|芭比娃娃-益智小游戏|Barbie Groovy Games (U)
GT ADVANCE 2AGWP|ＧＴＡ赛车进化版２|GT Advance 2 - Rally Racing (E)
DEPATIKA    ADYJ|中日洋３国桌上游戏大集合|Hanafuda Trump Mahjong - Depachika Wayouchuu (J)
EGGOMANIA   AEME|战斗蛋方块|Egg Mania (U)
SUPER GHOULSAG5E|超魔界村|Super Ghouls'n Ghosts (UE)
KELLY SLATERAS3E|凯利.史雷特之职业冲浪板|Kelly Slater's Pro Surfer (UE)
SMUGGLERSRUNASGE|走私者大赛车|Smuggler's Run (U)
DUKENUKEMUS AD9P|毁灭公爵|Duke Nukem Advance (E)
MCRAE RALLY2ACMP|越野精英赛|Colin McRae Rally 2.0 (E)
STREET FIGHTAZUJ|街霸３|Street Fighter Zero 3 Upper (J)
OUKOKUGAISUTAECJ|樱国之魂|Samurai Evolution - Oukoku Geist (J)
SEGA SMASH PA3PE|世嘉３合１强打游戏|Sega Smash Pack (U)
DRIVER 2 ADVADUP|横行霸道２|Driver 2 Advance (E)
CASTLEVANIA1ACHE|恶魔城-白夜协奏曲|Castlevania - Harmony of Dissonance (U)
UNIVERSLOTR ALOE|魔戒首部曲-魔戒现身|Lord of the Rings, The - The Fellowship of the Ring (U)
TENNISMASTERAT8P|网球大师系列２００３|Tennis Masters Series 2003 (E)
SPYRO 2     A2SE|宝贝龙2-火焰季节|Spyro 2 - Season of Flame (U)
JIMMY2002AGBAJXE|天才男孩吉米-纽顿ｖｓ吉米|Adventures of Jimmy Neutron Boy Genius vs. Jimmy Negatron (UE)
MIC&MIN MA  A3MP|米奇与米妮的奇妙冒险|Magical Quest Starring Mickey & Minnie (E)
HANAYANINAROAF7J|心跳系列１花店经营|Tokimeki Yume Series 1 - Ohanaya-san ni Narou! (J)
CARDE READERPSAE|卡片读取机|e-Reader (U)
RAVE2       ARIJ|圣石小子-光与暗的大决战２|Groove Adventure Rave - Hikari to Yami no Daikessen 2 (J)
EVILMIRROR  AHJP|雨果大冒险-邪恶之镜|Hugo - The Evil Mirror Advance (E)
WORMSWORLDPTAWYP|百战天虫|Worms World Party (E)
CHOBITS-MMV1AOCJ|人形电脑天使心|Chobits for Game Boy Advance - Atashi Dake no Hito (J)
SUPER MARIOCA3AP|超级玛丽奥３-耀西之岛|Super Mario Advance 3 - Yoshi's Island (E)
TEDDY       ATDJ|最爱泰迪熊|Daisuki Teddy (J)
SCOOBYMOVIEEAP8F|史酷比鬼屋历险-真人照片版|Scooby-Doo (F)
FROGQST     AFQP|青蛙大冒险|Frogger Advance - The Great Quest (E)
DINODEVICE BABIJ|转转蛋怪兽站-蓝版|Gachasute! Dino Device - Blue (J)
HARUKANARU  ARNJ|遥久时空|Harukanaru Toki no Naka de (J)
BKM BATTLES ABWE|神勇火星人-反冲大作战|Butt-Ugly Martians - B.K.M. Battles (U)
HAMSTER     AH7J|可爱宠物系列１-可爱仓鼠|Nakayoshi Pet Advance Series 1 - Kawaii Hamster (J)
KAWAII DOG  AI7J|可爱宠物系列２-可爱小狗|Nakayoshi Pet Advance Series 2 - Kawaii Koinu (J)
KAWAIIKONEKOAN3J|可爱宠物系列３-可爱小猫|Nakayoshi Pet Advance Series 3 - Kawaii Koneko (J)
MEDAROTGKBT AGHJ|徽章战士Ｇ-甲虫版|Medarot G - Kabuto Version (J)
PRINCESSBLUEA3HJ|姬骑士物语(公主骑士物语)|Hime Kishi Monogatari - Princess Blue (J)
GGXAE       AGXP|罪恶克星Ｘ|Guilty Gear X - Advance Edition (E)
SOCCER KID  AK6E|足球小子|Soccer Kid (UE)
BALLISTIC ECAEEE|出奇制胜(抵死冤家)|Ballistic - Ecks vs Sever (U)
DRAGONBALL ZALGP|七龙珠Ｚ-悟空传说|Dragon Ball Z - The Legacy of Goku (E)
ECKS VSE SEVAESP|艾克斯对塞弗|Ecks vs Sever (E)
FP2 NA      AFYE|火爆摔角２|Fire Pro Wrestling 2 (U)
INVADER     AIVP|侵略者|Invader (E)
MOTORACERADVA9MP|摩托英豪|Motoracer Advance (E)[b]
A.M.TURFWARSAY3E|玩具兵大战-草场战争|Army Men - Turf Wars (U)
METALGUN    AAPJ|枪战英豪|Metalgun Slinger (J)
AIRFORCEDELTAAKJ|空战神鹰风暴|AirForce Delta II (J)
TURBO TURTLEAK3E|音速龟大冒险|Turbo Turtle Adventure (U)
KINGOFEXNEOBAKOP|格斗天王ＥＸ|King of Fighters EX, The - NeoBlood (E)
HAROBOTSADVNAHQJ|哈罗机器人-机器人英雄战记|Harobots - Robo Hero Battling!! (J)
MONSTERFORCEAM8P|怪兽力量|Monster Force (E)
GROOVY GAMESAVBP|芭比娃娃-益智小游戏|Barbie Groovy Games (E)
THE REVENGE A7SP|蓝色小精灵-小精灵的大反击|Smurfs, The - The Revenge of the Smurfs (E)
DOTC        ADHE|保皇骑士(皇冠守护者)|Defender of the Crown (U)
DUAL BLADES AB9E|双刃|Dual Blades (U)
ICEAGE      AIAJ|冰原历险记|Ice Age (J)
JWEA2002    A2JJ|Ｊ联盟实况足球２００２|J.League Winning Eleven Advance 2002 (J)
PINBALL ADV APZP|弹珠台|Pinball Advance (E)
VIRTUATENNISAVTE|实战网球|Virtua Tennis (U)
G&W GALLERYAAQWP|任天堂怀旧掌机游戏|Game & Watch Gallery Advance (E)
OSYARE PRI  AOPJ|奥沙尔公主3|Oshare Princess (J)
SHREK HATC  AH4E|史瑞克-城堡找碴记|Shrek - Hassle at the Castle (U)
GALAXY ANGELAGZJ|银河天使|Moridakusan Tenshi no Full-Course - Okawari Jiyuu (J)
HH MLB 2003 AHXJ|火热职业联盟棒球2003|High Heat Major League Baseball 2003 (J)
ZOO CUBE    ANCJ|立体旋转方块|ZooCube (J)
HAMUPARAAGB AHAJ|黄金鼠乐园(天竺鼠乐园)|Hamster Paradise Advanchu (J)
DENKIBLOCKS!ADBJ|电击方块|Denki Blocks! (J)
PUKUPUKU-1  APUJ|狗狗小镇日记|PukuPuku Tennen Kairanban (J)
GACHINKOPRO ANYJ|实战职业棒球|Gachinko Pro Yakyuu (J)
BBC         AB6P|黑带之挑战|Black Belt Challenge (E)
YU-GI-OH!EDSAY5E|超时空要塞战记|Yu-Gi-Oh! - The Eternal Duelist Soul (U)
ROBO MACROSSARBE|游戏王５-永恒决斗者的灵魂|Robotech - The Macross Saga (UE)
XXX         AX3F|限制级战警|xXx (F)
WWTBAM      A55P|谁想成为百万富翁|Who Wants to Be a Millionaire (E)
GYAKUTEN_SA2A3GJ|逆转裁判２|Gyakuten Saiban 2 (J)
O_INKOCLUB  AICJ|奥沙博俱乐部|Oshaberi Inko Club (J)
CRAZY CHASE ACCP|疯狂追击|Crazy Chase (E)
SPIRIT: L'ETAC6F|野马的精神|Spirit - A la Recherche de la Terre Natale (F)
HOBOSAN     AHVJ|幼稚园|Nakayoshi Youchien - Sukoyaka Enji Ikusei Game (J)
ROBOT WARS EARSP|机器人的战争之无尽的毁灭|Robot Wars - Extreme Destruction (E)[b]
ACE LIGHTNINALXP|头号闪电|Ace Lightning (E)[b]
SSXTRICKY   AXYE|ＳＳＸ滑雪大赛|SSX Tricky (UE)
AGB KIRBY DXA7KJ|星之卡比-梦之泉|Hoshi no Kirby - Yume no Izumi Deluxe (J)
TARZANRTJ   AJGE|泰山重返丛林|Tarzan - Return to the Jungle (UE)
WWE_RTWM_X8 AW8E|ＷＷＥ职业摔跤|WWE - Road to WrestleMania X8 (UE)
BIONICLE MATA5AE|乐高积木冒险|Bionicle - Matoran Adventures (UE)
DOOM II     A9DE|毁灭战士２|Doom II (U)
SPYRO 2     A2SP|炸弹人杰特斯|Spyro 2 - Season of Flame (E)
BOM_JET.JPN AJZJ|宝贝龙2-火焰季节|Bomberman Jetters - Densetsu no Bomberman (J)
NARIKIRI2   AN9J|传说世界-换装迷宫２|Tales of the World - Narikiri Dungeon 2 (J)
METROID4USA AMTE|银河战士|Metroid Fusion (UA)
SANTA CLAUS AXXP|圣诞老人|Santa Claus Jr. Advance (E)
SECRETAGENTBAAHE|魔法芭比|Secret Agent Barbie - Royal Jewels Mission (U)
STUART LITTLASLF|超力鼠２|Stuart Little 2 (F)
MEGAMANBN2  AM2P|洛克人ＥＸＥ２|Megaman Battle Network 2 (E)
NHL HITZ 20 AN4E|曲棍球２００３|NHL Hitz 20-03 (U)
GEKIDO      AGEP|究级截拳道|Gekido Advance - Kintaro's Revenge (E)
CARBATTLERJOACBE|ＪＯＥ的汽车战斗|Car Battler Joe (U)
DEADLYSKIES AAKP|致命的天空|Deadly Skies (E)
BEASTSHOOTERAH5J|斗兽王|Beast Shooter - Mezase Beast King! (J)
SILK&COTTON A7IJ|丝绸与棉花|Silk to Cotton (J)
BP-BASEBALL A8YJ|最佳职业棒球|Best Play Pro Yakyuu (J)
TRAP2 MINAMIAODJ|南之海的奥德赛|Minami no Umi no Odyssey (J)
MONSTERFARM2A2QJ|怪兽农场进化版２|Monster Farm Advance 2 (J)
DIGICOM     A3OJ|美丽女孩商店|Di Gi Charat - DigiCommunication (J)
HE-MAN POWERAGUE|宇宙人希曼-骨之力量|Masters of the Universe He-Man - Power of Grayskull (U)
DDEOTB      AD4E|龙与地下城之目击者|Dungeons & Dragons - Eye of the Beholder (U)
TONY HAWK 4!AT6E|托尼职业滑板４|Tony Hawk's Pro Skater 4 (UE)
REIGN OF FIRAR9E|火焰王朝|Reign of Fire (U)
POCKY-ROCKY APKE|琶克洛克和贝克|Pocky & Rocky with Becky (U)
PPG HIM N SEAP5E|力量女孩Ｈｉｍ和ＳＥＥＫ|Powerpuff Girls, The - Him and Seek (U)
DEXTER CHESSADXE|幸运实验室-国际象棋挑战赛|Dexter's Laboratory - Chess Challenge (U)
DIS T PLANETAZQE|迪斯尼之宝藏行星|Treasure Planet (U)
CRAZY CHASE ACCE|疯狂追击|Crazy Chase (U)
GODZILLADOMIAG4P|哥斯拉大战|Godzilla - Domination! (E)[b]
UNIEUROLOTR ALOP|指环王－魔戒现身|Lord of the Rings, The - The Fellowship of the Ring (E)
DAVIS CUP   AD6E|戴维斯杯网球公开赛|Davis Cup (U)
TWO TOWERS  ALPE|指环王-双塔|Lord of the Rings, The - The Two Towers (UE)
INJUSTICEFORAJLE|正义同盟|Justice League - Injustice for All (U)
WWTBAM      A55D|谁想成为百万富翁|Wer wird Millionaer (G)
FAIRLYODDPARAFVE|恐怖的冒险少年|Fairly Odd Parents!, The - Enter the Cleft (U)
HPOTTER COS A7HE|哈里波特和秘密会所|Harry Potter and the Chamber of Secrets (UE)
CONTRAADVANCAAWE|魂斗罗ＥＸ|Contra Advance - The Alien Wars EX (U)
FG2 THE LOSTAFBE|青蛙大冒险２-失落的魔杖|Frogger's Adventures 2 - The Lost Wand (U)
PETSHOP3    A63J|可爱宠物店物语３|Kawaii Pet Shop Monogatari 3 (J)
SMUGGLERSRUNASGP|走私者大赛车|Smuggler's Run (E)
PPG HIMNSEEKAP5P|力量女孩Ｈｉｍ和ＳＥＥＫ|Powerpuff Girls, The - Him and Seek (E)
AGASSI TENNIACEP|齐达内足球２００２|Agassi Tennis Generation (E)
ZIDANE FOOTBAZDP|阿加西网球一代２００２|Zidane Football Generation (E)
DEFENDER    A2FE|防御者|Defender (U)
STAR WARS: TA2WE|星球大战-新德罗拉军|Star Wars - The New Droid Army (U)
DS_SOCCER_U A6DE|迪斯尼全明星足球|Disney Sports - Soccer (U)
DANDOHXI    AXHJ|大都西高尔夫|Dan Doh!! Xi (J)[b]
TOMB-RAIDER AL9P|古墓丽影-预言|Lara Croft Tomb Raider - The Prophecy (E)
THE MUMMY   AUMP|木乃伊|Mummy, The (E)
CONTRAADVANCAAWJ|魂斗罗ＥＸ|Contra Hard Spirits (J)
FIFA        AFJE|ＦＩＦＡ足球２００３|FIFA (UE)
DEBITIRUYAMIAC5J|真女神转生--暗黑之书|Shin Megami Tensei Devil Children - Yami no Sho (J)
ONPI7TSUJIMAAO7J|海贼王-荒岛大秘宝|From TV Animation One Piece - Nanatsu Shima no Daihihou (J)
PINK PANTHERAP7P|粉红之豹|Pink Panther - Pinkadelic Pursuit (E)
REVENGEOFSHIA3RE|西乐博的复仇|Revenge of Shinobi, The (U)
ROCKY BOXINGAR8E|洛克|Rocky (U)
CROKET!     A6CJ|馅饼2-黑暗邦克和邦公主|Croket! - Yume no Banker Survival! (J)
HOT WHEELS VAH8E|无敌烽火轮赛车Ｘ|Hot Wheels - Velocity X (U)
MKASWEET16  AAYE|玛莉凯特与艾希莉-甜蜜的16岁|Mary-Kate and Ashley Sweet 16 - Licensed to Drive (U)
RR GO PARTY AR5E|小淘气-我必须去宴会|Rugrats - I Gotta Go Party (UE)
HAM-CLUB3   AJHJ|仓鼠物语３|Hamster Club 3 (J)
SRWOG       AOGJ|超级机器人大战-原创世纪|Super Robot Taisen - Original Generation (J)
MONSTERRANC2A2QE|怪物农场２|Monster Rancher Advance 2 (U)
ISLAND XTREMAXTE|高乐多-异次元防御者|LEGO Island - Xtreme Stunts (UE)
GALIDOR     AG8E|乐高岛极限赛车|Galidor - Defenders of the Outer Dimension (U)
RCKTPWRBCHBNAR4E|动力火箭滑板-海滩的强盗|Rocket Power - Beach Bandits (UE)
THORNBERRYS AWLE|狂野丛林-电影|Wild Thornberrys Movie, The (UE)
MKALLIANCE  AXDE|真人快打-致命同盟|Mortal Kombat - Deadly Alliance (U)
SHREK HATC  AH4P|史瑞克-城堡找碴记|Shrek - Hassle at the Castle (E)
METROID4EUR AMTP|银河战士|Metroid Fusion (E)
DEBITIRUHIKAAL4J|真女神转生-光明之书|Shin Megami Tensei Devil Children - Hikari no Sho (J)
POKEMON SAPPAXPJ|口袋妖怪蓝宝石版本|Pocket Monsters - Sapphire (J)
DUNGEONS ANDAD4P|龙与地下城-可怕的魔眼|Dungeons & Dragons - Eye of the Beholder (E)
NAPOLEON F  ANPF|拿破仑|Aigle de Guerre, L' (F)
POKEMON RUBYAXVJ|口袋妖怪红宝石版本|Pocket Monsters - Ruby (J)
CAKE STORY  AAXJ|奇妙的蛋糕屋与动物占卜|Fantastic Maerchen - Cake-yasan Monogatari (J)
SCAN HUNTER A57J|卡片俱乐部|Scan Hunter - Sennen Kaigyo wo Oe! (J)
MONKEYBALLJRALUE|超级猴子球|Super Monkey Ball Jr. (U)
EGGOMANIA   AEMJ|战斗蛋方块|Egg Mania (J)
MOTOGP      AM4J|ＧＰ摩托车赛|Moto GP (J)
AGB-P-A8CJ  A8CJ|卡片俱乐部|Card Party (J)
SILENT SCOPEAIPJ|沉默狙击手|Silent Scope (J)
EARTHWORM JIAJ4P|蚯蚓吉姆２|Earthworm Jim 2 (E)
DISNEY TARZAAJGF|泰山-重返丛林|Tarzan - L'Appel de la Jungle (F)
PHANTASYSTARAYCE|梦幻之星１２３代合集|Phantasy Star Collection (U)
GAUNTLET_DL AYGE|圣铠传说-暗黑之遗产|Gauntlet - Dark Legacy (U)
KIM POSSIBLEAEYE|救世英雌|Kim Possible - Revenge of Monkey Fist (U)
MINORITY REPARME|关键报告|Minority Report - Everybody Runs (UE)
ALTEREDBEASTAARE|兽王记-王国之保卫者|Altered Beast - Guardian of the Realms (U)
AGB KIRBY DXA7KE|星之卡比-梦之泉|Kirby - Nightmare in Dream Land (U)
GBAZELDA    AZLE|萨尔达传说|Legend of Zelda, The - A Link to the Past & Four Swords (UA)
DIS T PLANETAZQP|迪斯尼之宝藏行星|Treasure Planet (E)
STREET FIGHTAZUP|街霸３|Street Fighter Alpha 3 Upper (E)
TITEUF ZE GAAT7F|坏小子|Titeuf - Ze Gagmachine (F)
LEGENDS OF WA2LE|摔角传奇２|Legends of Wrestling II (UE)
CQADVANCE2  AQ2J|可爱赛车Ｑ２|Choro Q Advance 2 (J)
WS POCKET 2 AJKJ|实况世界足球口袋版２|Jikkyou World Soccer Pocket 2 (J)
MEDALOFHONORAUGE|荣誉勋章|Medal of Honor - Underground (U)
STAR WARS: TA2WP|星球大战-新德罗拉军|Star Wars - The New Droid Army (E)
ZAPPER      AZPE|小蚱蜢-札克|Zapper (U)
CARRERA POWEAEDP|卡瑞拉冲锋小赛车|Carrera Power Slide (E)[b]
ROCKMAN_EXE3A6BJ|洛克人ＥＸＥ３|Battle Network Rockman EXE 3 (J)
WORMS BLAST AWBP|百战天虫|Worms Blast (E)
RR GO PARTY AR5F|小淘气-我必须去宴会|Razmoket, Les - A Moi la Fiesta (F)
WWTBAM      A55F|谁想成为百万富翁|Qui Veut Gagner des Millions (F)
HCPINBALL   AH6E|天然弹珠球|Hardcore Pinball (UE)
ECKS VS SEV2AEEP|出奇制胜２(抵死冤家２)|Ecks vs Sever II - Ballistic (E)
TUROK EVOL  AT4E|恐龙猎人进化版|Turok Evolution (U)
DAVE MIRRA 3AB3E|大卫米拉自由赛车３|Dave Mirra Freestyle BMX 3 (UE)
PBDRBYSTLON A8PJ|英国中部都市赛马|Derby Stallion Advance (J)
KINNIKUMAN21AK2J|金肉人２世-迈向正义超人之道|Kinnikuman IIsei - Seigi Choujin heno Michi (J)
HPOTTER COS A7HJ|哈里波特和秘密会所|Harry Potter to Himitsu no Heya (J)
SHAMAN KING3AL3J|通灵王-超占事略决３|Shaman King Card Game - Chou Senjiryakketsu 3 (J)
WWCC5       AWWP|啄木鸟伍迪勇闯疯狂城堡|Woody Woodpecker in Crazy Castle 5 (E)
TIRETBUT    ATVP|益智足球|Tir et But - Edition Champions du Monde (E)
M.M.4 K.DICEAA5J|怪兽制造厂４-闪光卡片|Monster Maker 4 - Flash Card (J)
M.M.4 F.CARDAA4J|怪兽制造厂４-杀手骰子|Monster Maker 4 - Killer Dice (J)
DARIUS R    A2DJ|太空战斗机Ｒ|Darius R (J)
MAGINATION  A2IJ|指轮魔境传|Magi Nation (J)
KLONOAHEROESAK7J|风之少年-传说的星之徽章|Klonoa Heroes - Densetsu no Star Medal (J)
BATTLEBOTS  ABEE|战斗机器人-困兽之斗|BattleBots - Beyond the BattleBox (U)
HAJIMENOIPPOA2HJ|第一神拳|Hajime no Ippo - The Fighting! (J)
LUNAR LEGENDALNE|银河之星－露娜传奇|Lunar Legend (U)
PINBALL TYCNA2TE|弹珠台大亨|Pinball Tycoon (U)
MONSTER BASSA4BE|怪物巴斯钓鱼大赛|Monster! Bass Fishing (U)
ISPY CHALNGRA4CE|我的间谍挑战之旅|I Spy Challenger! (U)
DS_BASKET_U A2AE|迪斯尼明星运动会-街头篮球篇|Disney Sports - Basketball (U)
DS-SKATE-U  A4DE|迪斯尼明星运动会-滑板|Disney Sports - Skateboarding (U)
DS-FOOTBALLUA3DE|迪斯尼明星运动会-美式足球|Disney Sports - Football (U)
SONICADVANC2A2NJ|音速小子２代|Sonic Advance 2 (J)
SEGA RALLY  AYLJ|世嘉拉力赛车|Sega Rally Championship (J)
DORA THE EXPAERE|小冒险家朵拉-寻找海盗小猪|Dora the Explorer - The Search for the Pirate Pig's Treasure (U)
KARNAAJ     AYKE|战斗拉力赛车|Karnaaj Rally (UE)
THE INVINCIBAIOE|漫画英雄-无敌铁人|Invincible Iron Man, The (UE)
AEROMXXXXXXXAAOJ|杂技小孩|Acrobat Kid (J)
CHOCO VADER AUCJ|宇宙大作战|Uchuu Daisakusen Choco Vader - Uchuu Kara no Shinryakusha (J)
TOKON HEAT  A59J|斗魂比特|Toukon Heat (J)
ELEVATORACT ANWJ|电梯大作战-新版与旧版|Elevator Action - Old & New (J)
CHOCOBOLAND A5BJ|陆行鸟大陆-游戏的骰子|Chocobo Land - A Game of Dice (J)
CABELAS BGH A8HE|猎人游戏|Cabela's Big Game Hunter (U)
S BUBBLE POPAVZE|超级泡泡|Super Bubble Pop (U)
JAZZJACKRABBAJJE|爵士的小兔|Jazz Jackrabbit (U)
SEA TRADER  ALJE|海洋商人之太盘的繁荣|Sea Trader - Rise of Taipan (U)
REVENGEOFSHIA3RP|西乐博的复仇|Revenge of Shinobi, The (E)
HANAYA      A87J|花店物语|Ohanaya-san Monogatari - Iyashikei Ohanaya-san Ikusei Game (J)
DUAL BLADES AB9J|双刃|Dual Blades (J)
KOFEX2HOWLINAEXJ|格斗天王ＥＸ２-咆哮之血|King of Fighters EX2, The - Howling Blood (J)
WWTBAM      A55I|谁想成为百万富翁|Chi Vuol Essere Milionario (I)
SAMURAI-MMV1AOSJ|鬼眼狂刀|Samurai Deeper Kyo (J)[b]
BO_BOBO_GBA A8VJ|爆裂鼻毛真拳|Boboboubo Boubobo - Ougi 87.5 Bakuretsu Hanage Shinken (J)
TENIPURI2   AVAJ|网球王子|Tennis no Ouji-sama - Aim at the Victory! (J)
DISNEY'S TARAJGD|人猿泰山|Tarzan - Rueckkehr in den Dschungel (G)
BAYBLADE_3D A3EJ|爆旋陀螺２００２?龙之章|Beyblade 2002 - Kouryuu no Shou - Daichi Hen (J)
BAYBLADE_3T A3WJ|爆旋陀螺２００２青龙之章|Beyblade 2002 - Seiryuu no Shou - Takao Hen (J)
HAPPYCAKE   A56J|快乐卡其|Dokidoki Cooking Series 1 - Komugi-chan no Happy Cake (J)
GODZILLADOMIAG4E|哥斯拉大战|Godzilla - Domination! (U)
HIGANBANA   AHZJ|彼岸花|Higanbana (J)
INSPECTOR GAAIRP|嘎杰特赛车|Inspector Gadget Racing (E)
F1 2002     AF8E|Ｆ１方程式赛车２００２|F1 2002 (U)
MEDABOTSMTBVA8BP|金属机器人大战-蓝蜂版|Medabots - Metabee Version (E)
K-1POCKE_GP2A2OJ|Ｋ－１口袋格斗大奖赛２|K-1 Pocket Grand Prix 2 (J)
KURUPARA    A9QJ|滚滚棒天堂|Kururin Paradise (J)
CRASH2      AC8E|古惑狼２|Crash Bandicoot 2 - N-Tranced (U)
DIEMONSTERAGAMXD|怪兽公司|Monster AG, Die (G)
MOJIPITTAN  A8MJ|智力拼字|Kotoba no Puzzle - Mojipittan Advance (J)
JUNGLEBOOK2 AJFP|迪斯尼－丛林之书２|Jungle Book 2, The (E)
LITTLEBUSTERALQJ|小破坏者Ｑ|Little Buster Q (J)
MICRO MACHINAXZP|微型机器赛车|Micro Machines (E)
DIGIMON BTSPA8SE|数码暴龙格斗之魂|Digimon - Battle Spirit (U)
TAXI 3      AXQF|出租车３|Taxi 3 (F)
ISS ADVANCE AY2P|世界超级明星足球|International Superstar Soccer Advance (E)
PAWAPOKE5   A5PJ|实况野球５|Power Pro Kun Pocket 5 (J)
ANISNOATORIEANSJ|炼金术士|Marie, Elie & Anis no Atelier - Soyokaze Kara no Dengon (J)
B-DASH EX   ABDJ|推石小子ＥＸ|Boulder Dash EX (J)
INUYASYANARAAIYJ|犬夜叉-奈落之圈套|Inuyasha - Naraku no Wana! Mayoi no Mori no Shoutaijou (J)
ELEMIX!     AEKJ|魔法冒险|Elemix! (J)
DAREDEVIL   AVLE|夜魔侠|Daredevil (UE)
GT ADVANCE 3A2GE|ＧＴＡ赛车３-职业概念赛|GT Advance 3 - Pro Concept Racing (U)
MINIMONIAGB AOHJ|迷你早安-落在山脊上的星星|Minimoni - Onegai Ohoshi-sama! (J)
ROCK_EXE3_BKA3XJ|洛克人ＥＸＥ３黑|Battle Network Rockman EXE 3 Black (J)
FFT_ADVANCE AFXJ|最终幻想战略版|Final Fantasy Tactics Advance (J)
YU-GI-OH DDMAYDE|游戏王-怪兽龙门骰|Yu-Gi-Oh! - Dungeon Dice Monsters (U)
SHINING SOULAHUP|光明之魂|Shining Soul (E)
IK PLUS     A3KP|国际空手道大赛-加强版|International Karate Plus (E)
DEMON DRIVERA9AP|魔鬼赛车手|Demon Driver - Time to Burn Rubber! (E)
SPR DROPZONEAZNP|超级月面地带|Archer Maclean's Super Dropzone (E)
STADIUMGAMESA9GP|田径游戏|Stadium Games (E)
HYDRA       AFHP|决战九头蛇|Strike Force Hydra (E)
WORLD TENNISAWCP|世界网球明星|World Tennis Stars (E)
RAYMAN 3    AYZP|雷曼３|Rayman 3 (E)
TWO TOWERS  ALPJ|指环王-双塔|Lord of the Rings, The - Futatsu no Tou (J)
METROID4JPN AMTJ|银河战士|Metroid Fusion (J)
MANGAKA     ACOJ|漫画家物语|Manga-ka Debut Monogatari (J)
ALICE       AF4J|爱丽斯梦游仙境|Fushigi no Kuni no Alice (J)
SPYRO       A4SJ|宝贝龙2-火焰季节|Spyro Advance (J)
BUBBLEBOBBLEAONP|泡泡龙-旧版＆新版|Bubble Bobble - Old & New (E)
MUGENBORG   AG6J|无限战人|Mugenborg (J)
GBAZELDA    AZLP|萨尔达传说|Legend of Zelda, The - A Link to the Past & Four Swords (E)
KCEJ TP2K3R A8RJ|网球王子２００３-火红版|Tennis no Ouji-sama 2003 - Passion Red (J)
KCEJ TP2K3B A9LJ|网球王子２００３-冰蓝版|Tennis no Ouji-sama 2003 - Cool Blue (J)
TOTALSOCCER ATUJ|冠军足球|Total Soccer Advance (J)
LODE RUNNER A39J|挖金子|Lode Runner (J)
BKM BATTLES AUQP|神勇火星人-反冲大作战|Butt-Ugly Martians - B.K.M. Battles (E)
ALLSTAR 2004AA7E|全美明星棒球|All-Star Baseball 2004 (U)
PHANTASY STAAYCP|梦幻之星合集|Phantasy Star Collection (E)
WINGS       AWQE|翼|Wings (U)
MIRUMODEPON!AWKJ|黄金响葫芦的传说|Wagamama Fairy Mirumo de Pon! - Ougon Maracas no Densetsu (J)
ZAPPER      AZPP|小蚱蜢-札克|Zapper (E)
VIRTUA TENNIAVTP|虚拟网球|Virtua Tennis (E)
TOW SUMMLINEA9PJ|世界传说-召唤者之血|Tales of the World - Summoner's Lineage (J)
TOCA        ATQP|ＴＯＣＡ世界巡回赛车|TOCA World Touring Cars (E)
AGB-P-A52J  A52J|单词-英语篇|Koukou Juken Series Eitango Hen - 2000 Words Shuuroku (J)
POKEMON SAPPAXPE|口袋妖怪蓝宝石版本|Pokemon - Sapphire Version (U)
STREET FIGHTAZUE|街霸３|Street Fighter Alpha 3 Upper (U)
GBAZELDA    AZLJ|萨尔达传说|Zelda no Densetsu - Kamigami no Triforce & 4tsu no Tsurugi (J)
TOM AND JERRAIFE|猫和老鼠|Tom and Jerry in Infurnal Escape (U)
MEGAMAN&BASSA6ME|洛克人和弗斯特|Megaman & Bass (U)
SEGA RALLY  AYLE|世嘉拉力赛车|Sega Rally Championship (U)
DEFENDER    A2FP|防御者|Defender - For All Mankind (E)
CRASH2      AC8P|古惑狼２|Crash Bandicoot 2 - N-Tranced (E)
SONICADVANC2A2NE|音速小子２代|Sonic Advance 2 (U)
POKEMON RUBYAXVE|口袋妖怪红宝石版本|Pokemon - Ruby Version (U)
YUGIOU DM8  AY8J|游戏王8-破灭之大邪神|Yu-Gi-Oh! - Duel Monsters 8 - Hametsu no Daijashin (J)
MADEINWARIO AZWJ|瓦里奥制造(坏玛丽游戏大集合)|Made in Wario (J)
NIGHTFIRE   A7OE|詹姆斯邦德007-夜火|007 - NightFire (UE)
BRATZ       A2RE|跳舞机|Bratz (U)
MUPPETS SHOWAZME|芝麻街-演出开始啦！|Muppets, The - On With the Show! (UE)[b]
PIGLET'SGAMEA9NE|小猪大游戏|Piglet's Big Game (U)
THE LOST VIKALVP|失落的维京战士|Lost Vikings, The (E)[b]
DR. MUTO    A6TP|疯狂博士|Dr. Muto (E)[b]
SONIC ADVANCA2NP|索尼克大冒险|Sonic Advance 2 (E)
SAMURAIJACK AJTE|日本武士杰克-时间之护身符|Samurai Jack - The Amulet of Time (UE)
SLUGFEST2K4 A5ME|美国职棒大联盟2004|MLB SlugFest 20-04 (U)[b]
ONEPIECEKINGAUSJ|海贼王-目标！赏金之王！|From TV Animation One Piece - Mezase! King of Berry (J)
DAREDEVIL   AVLD|夜魔侠|Daredevil (G)
BRUCE LEE   ALEP|李小龙-传说中的英雄再现|Bruce Lee - Return of the Legend (E)
ANIMAL SNAP AAQP|动物方块-拯救它们|Animal Snap - Rescue Them 2 By 2 (E)
UBG         ABUE|终极智力游戏|Ultimate Brain Games (UE)
SISTERP-MMV1A4PJ|妹妹公主|Sister Princess - RePure (J)
CASTLEWEEN  AWNP|古堡幽灵|Castleween (E)
SUPERMAN CTAASUE|超人：回到地球|Superman - Countdown to Apokolips (U)
PUZZLEFIGHT2AZ8P|超级街霸方块II|Super Puzzle Fighter II Turbo (E)
SHIMURA_KEN A64J|志村健之白痴殿下-爆笑天下统一游戏|Shimura Ken no Baka Tonosama - Bakushou Tenka Touitsu Game (J)
INUKKO-CLUB AI9J|小狗俱乐部-福丸之大冒险|Inukko Club (J)
DQM-CARAVANHA9HJ|勇者斗恶龙怪物篇3-旅团之心|Dragon Quest Monsters - Caravan Heart (J)
JIMMY2GER   AJXD|天才男孩吉米中子VS吉米负电子|Jimmy Neutron vs. Jimmy Negatron (G)
GREMLINS STRAGGP|魔怪小精灵|Gremlins - Stripe vs Gizmo (E)
DDS_1       AAUJ|真女神转生|Shin Megami Tensei (J)
WWTBAM      A55S|谁想成为百万富翁|Quiere Ser Millonario (S)
DRIVER2ADV  ADUE|横行霸道２|Driver 2 Advance (U)
ED EDD EDDY AE3E|Ed，Edd和Eddy-唠叨的家伙们|Ed, Edd n Eddy - Jawbreakers! (U)[b]
SUPER MONKEYALUP|超级猴子球|Super Monkey Ball Jr. (E)
SANTA       AUZE|圣诞老人救地球|Santa Claus Saves the Earth (E)
MEDABOTSRKSVA9BP|金属机器人大战-六书版|Medabots - Rokusho Version (E)[b]
GOLDEN_SUN_BAGFE|黄金太阳2-失落的时代|Golden Sun - The Lost Age (UE)
NINJA COP   ANXP|忍者刑警|Ninja Cop (E)
DISNEY PRINCAQPE|迪士尼公主|Disney Princess (UE)
BOMBERMAN MAAMHP|炸弹人MAX2-蓝版|Bomberman Max 2 - Blue Advance (E)
BMAX2-RED   AMYP|炸弹人MAX2-红版|Bomberman Max 2 - Red Advance (E)
WHISTLE!    A73J|哨声响起|Dai 37 Kai Tokyo-to Chuugakkou Sougou Taiiku Soccer Taikai (J)
AOZORA      AAZJ|梦之冒险|Ao-Zoura to Nakamatachi - Yume no Bouken (J)
HAMUTARO3   AH3E|哈姆太郎３|Hamtaro - Ham-Ham Heartbreak (U)
CRAZY TAXI CA3CE|疯狂出租车|Crazy Taxi - Catch a Ride (U)
DAREDEVIL   AVLX|夜魔侠|Daredevil (E)
FREESTYLE SCARFP|极限时髦滑板车|Freestyle Scooter (E)
MORTAL KOMBAAM5P|真人快打|Mortal Kombat Advance (E)
DANCINGSWORDA9SJ|舞之刃|Dancing Sword - Senkou (J)
LOSTVIKINGS ALVE|失落的维京战士|Lost Vikings, The (U)
YUGIOHWWE   AYWP|游戏王6-国际版|Yu-Gi-Oh! - Stairway to the Destined Duel (E)
X2 WOLVERINEAWVE|X战警2-狼人之复仇|X2 - Wolverine's Revenge (UE)
BOKUMONOGBA A4NJ|牧场物语|Bokujou Monogatari - Mineral Town no Nakamatachi (J)
ESPN FISHNG3AMGJ|刺激钓鱼|Exciting Bass (J)
PINK PANTHERAPEE|粉红之豹|Pink Panther - Pinkadelic Pursuit (U)
GBA_SENGOKU1A7GJ|战国革命外传|Sengoku Kakumei Gaiden (J)
MEDACOREKBT A5KJ|金属机械器人2－甲?版|Medarot Ni Core - Kabuto Version (J)
MCRAE RALLY2ACME|越野精英赛|Colin McRae Rally 2.0 (U)
SLOT!PRO2   ATBJ|专业柏青嫂游戏2－走开骗子|Slot! Pro 2 Advance - GoGo Juggler & New Tairyou (J)
SYLVANIA4   A4LJ|森林之家4|Sylvanian Families 4 - Meguru Kisetsu no Tapestry (J)
TETSUMAN AGBANTJ|日本职业麻将－?万|Mahjong Renmei Kounin Tetsuman - Menkyo Kaiden Series (J)
WATASHI-MK  AW3J|我的彩?世界|Watashi no Makesalon (J)
DS_BASKET   A2AJ|迪斯尼全明星运动系列-篮球|Disney Sports - Basketball (J)
AGB-P-A53J  A53J|高校受验系列-英熟?语篇-650片语收?|Koukou Juken Series Eijukugo Hen - 650 Phrases Shuuroku (J)
ZOIDSSAGA2  AZ2J|机兽新世纪2|Zoids Saga II (J)
GURUMI      A2VJ|魔法之冒险|Kisekko Gurumi -Chesty to Nuigurumi-tachi no Mahou no Bouken(J)
MEDACOREKWG A5QJ|金属机器人2－?型虫版|Medarot Ni Core - Kuwagata Version (J)
RETSUDENGBA ARAJ|新日本职业摔跤－斗魂烈传|Shin Nihon Pro Wrestling - Toukon Retsuden Advance (J)
02:BK@2960  AZ9J|简单2960打砖块系列2－障碍崩溃|Simple 2960 Tomodachi Series Vol. 2 - The Block Kuzushi (J)
LETSBASSFISHAZBJ|钓鲈巡回赛！－夺标就是战略！|Bass Tsuri Shiyouze! - Tournament ha Senryaku da! (J)
TOMB-RAIDER AUTJ|古墓丽影-预言|Lara Croft Tomb Raider - The Prophecy (J)
FANCYPOCKET AJEJ|口袋精品店|Fancy Pocket (J)
OSYARE PRI2 AO2J|奥沙尔公主2和动物占卜|Oshare Princess 2 (J)
SUPERMAN: COASUP|超人：回到地球|Superman - Countdown to Apokolips (E)
SEGA RALLY CAYLP|世嘉拉力赛车|Sega Rally Championship (E)
FIREEMBLEM7 AE7J|火炎之纹章－烈火之剑|Fire Emblem - Rekka no Ken (J)
SUMMONIGHCSSAB4J|召唤之夜－铸剑物语|Summon Night - Craft Sword Monogatari (J)
RPGTCOOLGBA A8TJ|RPG创造|RPG Tsukuru Advance (J)
SUM ALL FEARAA6E|恐惧的总和|Sum of All Fears, The (U)
HUNTER GBA00A8NJ|猎人X猎人－热血友情大作战|Hunter X Hunter - Minna Tomodachi Daisakusen!! (J)
X2 WOLVERINEAWVF|X战警2-狼人之复仇|X-Men 2 - La Vengeance de Wolverine (F)
RAYMAN 3    AYZE|雷曼３|Rayman 3 (U)
AZUMANGALINKAZAJ|漫画大王|Azumanga Daiou Advance (J)
DS_MOTOCROSSAOME|迪斯尼全明星体育系列－摩托车篇|Disney Sports - Motocross (U)
PLUSTER RACEA2PJ|冒险游记GP赛车|Bouken Yuuki Pluster World - Pluston GP (J)
ZERO ONE    AF3J|对与错|Zero One (J)
ROCKMANZERO2A62J|洛克人ZERO2|Rockman Zero 2 (J)
01:TBC@2960 AZKJ|桌面游戏全集|Simple 2960 Tomodachi Series Vol. 1 - Table Game Collection (J)
DROME RACERSAOEX|LEGO疯狂赛车|Drome Racers (E)
SPLINTERCELLAO4E|分裂细胞|Tom Clancy's Splinter Cell (U)
NARUTO ACT1 A7AJ|火影忍者－最强忍者大结集|Naruto - Ninjutsu Zenkai! Saikyou Ninja Daikesshuu (J)[b]
PUZZLEFIGHT2AZ8E|超级街霸方块II|Super Puzzle Fighter II Turbo (U)
CASTLEVANIA2A2CJ|恶魔城－晓月圆舞曲|Castlevania - Akatsuki no Minuet (J)
CASTLEVANIA2A2CP|恶魔城|Castlevania - Aria of Sorrow (E)
LUFIA       AGDE|沉默的遗迹－四狂神战记外传|Lufia - The Ruins of Lore (U)
CASTLEVANIA2A2CE|恶魔城|Castlevania - Aria of Sorrow (U)
MEDALOFHONORAUGX|荣誉勋章|Medal of Honor - Underground (E)(Ubi Soft)
TOM AND JERRAIFP|猫和老鼠|Tom and Jerry in Infurnal Escape (E)
YUGIOHWWE   AYWJ|游戏王6-国际版|Yu-Gi-Oh! - Duel Monsters - International Worldwide Edition (J)
KITCHENBENTOA8OJ|美食家的厨房|Dokidoki Cooking 2 - Gourmet Kitchen - Suteki na Obentou (J)
FINDING NEMOAZIE|海底总动员|Finding Nemo (UE)
WARIOWAREINCAZWE|瓦里奥制造(坏玛丽游戏大集合)|WarioWare, Inc. - Mega Microgames! (U)
MBXCTH      ARQP|救火英雄|Matchbox Cross Town Heroes (E)
SPIRIT: DER AC6D|精灵马|Spirit - Der wilde Mustang - Auf der Suche nach Homeland (G)
FINDET NEMO AZID|海底总动员|Findet Nemo (G)
IRIDIONII   AI2E|伊登战机II|Iridion II (U)
IRIDIONII   AI2P|伊登战机II|Iridion II (E)
BUFFY       AVYD|吸血鬼杀手巴菲-返回黑暗世界|Buffy - Im Bann der Daemonen - Koenig Darkhuls Zorn (G)
WARIOWAREINCAZWP|瓦里奥制造(坏玛丽游戏大集合)|WarioWare, Inc. - Minigame Mania (E)
RAREDKC1    A5NP|超级大金刚|Donkey Kong Country (E)
SEGA ARCADE AYPP|世嘉街机游戏集锦|Sega Arcade Gallery (E)
DANCE BEAT  ABYY|小甜甜布兰妮之舞蹈节拍|Britney's Dance Beat (E)
WWTBAM      A55H|谁想成为百万富翁|Weekend Miljonairs (NL)
BRATZ       A2RP|跳舞机|Bratz (E)
AGASSITENNISACEE|阿加西网球|Agassi Tennis Generation (U)
YUGIOHWWE   AYWE|游戏王6-国际版|Yu-Gi-Oh! - Stairway to the Destined Duel (U)
DS_SOCCER_E A6DP|迪斯尼全明星体育系列-滑冰板|Disney Sports - Skateboarding (E)
DS-SKATE-E  A4DP|迪斯尼全明星体育系列-足球|Disney Sports - Football (E)
MIDNIGHTCLUBAMQP|午夜俱乐部-湾岸街头赛车|Midnight Club - Street Racing (E)
HAMUTARO4   A84J|哈姆太郎4-虹色大行进|Tottoko Hamutarou 4 - Nijiiro Daikoushin Dechu (J)
DS_SNOWBD_E A5DP|迪斯尼全明星体育系列|Disney Sports - Snowboarding (E)
CHESSMASTER ACYE|西洋棋大师|Chessmaster (U)
SPIRIT: STALAC6P|小马王|Spirit - Stallion of the Cimarron - Search for Homeland (E)
HAMSTAR3    A83J|仓鼠物语3|Hamster Monogatari 3 GBA (J)
WWCC5       AWWJ|啄木鸟伍迪勇闯疯狂城堡|Woody Woodpecker - Crazy Castle 5 (J)
PAZ TANTEI  AEHJ|方块和侦探游戏合集|Puzzle & Tantei Collection (J)
GB METRO    A8GJ|闪灵二人组-首都夺还作战|GetBackers Dakkanya - Metropolis Dakkan Sakusen! (J)
TONY HAWK 3!AT3D|汤尼.霍克专业滑板３|Tony Hawk's Pro Skater 3 (G)
PRO BEACH SOAVEP|职业沙滩足球|Pro Beach Soccer (E)
HULKV1      AHLE|变相怪杰绿巨人|Incredible Hulk, The (U)
WING COMMANDAW9E|银河飞将-预言|Wing Commander - Prophecy (U)
PLUSTER RPG APJJ|冒险游记-未发现的传说|Bouken Yuuki Pluster World - Densetsu no Plust Gate (J)
RUGRATSGWILDA5WE|鲁加特野外历险记|Rugrats - Go Wild (UE)
MEDABOTS_MTBAK8P|金属机器人大战AX-蓝蜂版|Medabots AX - Metabee Version (E)[b]
BOYSSOCCER 2A2ZJ|全日本少年足球大会2-目标！日本第一|Zen-Nihon Shounen Soccer Taikai 2 - Mezase Nihon-ichi! (J)
SCOOBYMOVIEEAP8D|史酷比鬼屋历险-真人照片版|Scooby-Doo (G)
GT ADVANCE 3A2GP|ＧＴＡ赛车３-职业概念赛|GT Advance 3 - Pro Concept Racing (E)
SONICPINBALLA3VE|索尼克弹珠派对|Sonic Pinball Party (U)
SPIDER-MAN  AKXD|蜘蛛人-电影版|Spider-Man (G)
TOM CLANCY'SAO4P|分裂细胞|Tom Clancy's Splinter Cell (E)
FORTRESS    AFOP|城堡建筑战|Fortress (E)
WOLF3D      AWOP|德军总部３Ｄ|Wolfenstein 3D (E)
MEGAMAN&BASSA6MP|洛克人和弗斯特|Megaman & Bass (E)
GEKITOU NOAHANNJ|激斗传说拳击-梦幻经理人|Gekitou Densetsu Noah - Dream Management (J)
UMUSCLE     AK2E|终极筋肉人-超级英雄之路|Ultimate Muscle - The Path of the Superhero (U)
HULKV1      AHLP|变相怪杰绿巨人|Incredible Hulk, The (E)
SMPW!!!!!!!!AWDE|极限水上滑板|Wakeboarding Unleashed featuring Shaun Murray (E)
FASHION     AFNJ|天使的收藏品|Angel Collection - Mezase! Gakuen no Fashion Leader (J)
MAHOUPUMPKINAWNJ|魔法南瓜头|Mahou no Pumpkin - Ann to Greg no Daibouken (J)
CRAZY TAXI CA3CP|疯狂出租车|Crazy Taxi - Catch a Ride (E)
FG2 THE LOSTAFBP|青蛙大冒险２-失落的魔杖|Frogger's Adventures 2 - The Lost Wand (E)
RAREDKC1    A5NE|超级大金刚|Donkey Kong Country (U)
DRAGONBALL ZALFP|七龙珠Ｚ-悟空传说|Dragon Ball Z - The Legacy of Goku II (E)
SEGA SMASH PA3PP|世嘉３合１强打游戏|Sega Smash Pack (E)
DS-MOTOCROSSAOMJ|迪斯尼全明星体育系列－摩托车篇|Disney Sports - Motocross (J)
DS_SNOWBD   A5DJ|迪斯尼全明星体育系列-滑雪板|Disney Sports - Snowboarding (J)
ADVANCEWARS2AW2E|大战争2-黑洞的升起|Advance Wars 2 - Black Hole Rising (UA)
LLB 2002    ALCE|小型棒球联赛2002|Little League Baseball 2002 (U)
NINJA FIVE 0ANXE|忍者刑警|Ninja Five-0 (U)
MONSTERGATE2A6GJ|怪兽之门2|Monster Gate - Ooinaru Dungeon - Fuuin no Orb (J)
EGGOMANIA   AEMP|战斗蛋方块|Eggo Mania (E)
STUNTMAN    AUXP|特技人|Stuntman (E)
BATTLEBOTS  ABEP|战斗机器人-困兽之斗|BattleBots - Beyond the BattleBox (E)
DS_BASKET_E A2AP|迪斯尼全明星运动系列-篮球|Disney Sports - Basketball (E)
DS_MOTOCROSSAOMP|迪斯尼全明星体育系列－摩托车篇|Disney Sports - Motocross (E)
MOTHER12    A2UJ|母亲1+2|Mother 1+2 (J)
METALMAX2KAIA9TJ|重装机兵2-改|Metal Max 2 Kai (J)
SPACE CHANNEA5UE|太空频道5|Space Channel 5 - Ulala's Cosmic Attack (U)
LEGO DROME RAOEE|乐高疯狂赛车|Drome Racers (U)
KING OF FIGHAEXE|格斗之王EX2|King of Fighters EX2, The - Howling Blood (E)
INJUSTICEFORAJLP|正义同盟|Justice League - Injustice for All (E)
HAMUTARO3   AH3P|哈姆太郎３|Hamtaro - Ham-Ham Heartbreak (E)
RRRACING    A4RE|摇滚赛车|Rock n' Roll Racing (U)
PIRATESCARIBA8QE|加勒比海盗|Pirates of the Caribbean - The Curse of the Black Pearl (U)
MEGA_EXE3_BLA3XE|洛克人网络战斗3-蓝|Megaman Battle Network 3 Blue (U)
PUNCH KING  APGP|击倒王|Punch King - Arcade Boxing (E)
MEGA_EXE3_WHA6BE|洛克人网络战斗3-白|Megaman Battle Network 3 White (U)
STUNTMAN    AUXE|特技人|Stuntman (U)
JETGRNDRADIOAJRE|喷射小子-街头涂鸦|Jet Grind Radio (U)
SIMPSONSRAGEA4AE|辛普森疯狂大道|Simpsons, The - Road Rage (UE)
BUFFY       AVYE|龙珠Z-悟空的遗产2|Buffy the Vampire Slayer - Wrath of the Darkhul King (UE)
DBZLGCYGOKU2ALFE|吸血鬼杀手巴菲-返回黑暗世界|Dragon Ball Z - The Legacy of Goku II (U)
DISNEY PRINCAQPD|迪士尼公主|Disneys Prinzessinnen (G)
FG2 THE LOSTAFBJ|青蛙大冒险２-失落的魔杖|Frogger - Mahou no Kuni no Daibouken (J)
HACHIEMON   A8EJ|哈欠妖怪|Hachiemon (J)
HAMSTAR COLLBHCJ|仓鼠太郎大收藏|Hamster Monogatari Collection (J)
KABUKUWA    BKKJ|大家的养育系列3|Minna no Shiiku Series - Boku no Kabuto-Kuwagata (J)
F1 2002     AF8X|Ｆ１方程式赛车２００２|F1 2002 (E)
POKEMON SAPPAXPD|口袋妖怪蓝宝石版本|Pokemon - Saphir-Edition (G)
SUPER MARIODAX4J|超级马里奥4|Super Mario Advance 4 (J)
SPY KIDS IIIAV3E|间谍小子3-D|Spy Kids 3-D - Game Over (U)
TITEUF, ZE GAT7P|丁丁历险记|Tootuff - The Gagmachine (E)
M&M MAGICAL2A29J|迪斯尼米老鼠2|Mickey to Minnie no Magical Quest 2 (J)
CROKET!2    BK2J|馅饼2-黑暗邦克和邦公主|Croket! 2 - Yami no Bank to Banqueen (J)
KAWAIIKOGATABKIJ|动物伴侣系列四-可爱小狗|Kawaii Koinu Mini - Wankoto Asobou!! Kogata-ken (J)
GET! AGB    BGBJ|捉住!我的捕虫日记|Get! - Boku no Mushi Tsukamaete (J)
HAMUPARAPUREA82J|火腿太郎乐园清纯之心|Hamster Paradise - Pure Heart (J)
WING COMMANDAW9P|银河飞将-预言|Wing Commander - Prophecy (E)
BOKUTAI     U3IJ|我们的太阳|Bokura no Taiyou - Taiyou Action RPG (J)
SONICPINBALLA86J|索尼克弹珠派对|Sonic Pinball Party (J)
POKEMON RUBYAXVI|口袋妖怪红宝石版本|Pokemon - Versione Rubino (I)
POKEMON SAPPAXPI|口袋妖怪蓝宝石版本|Pokemon - Versione Zaffiro (I)
POKEMON RUBYAXVD|口袋妖怪红宝石版本|Pokemon - Rubin-Edition (G)
ONITAC1     A6OJ|鬼武者战略版|Onimusha Tactics (J)
HAM-CLUB4   A4KJ|仓鼠太郎俱乐部4|Hamster Club 4 (J)
POKEMON SAPPAXPS|口袋妖怪蓝宝石版本|Pokemon - Edicion Zafiro (S)
POKEMON RUBYAXVS|口袋妖怪红宝石版本|Pokemon - Edicion Rubi (S)
POKEMON SAPPAXPF|口袋妖怪蓝宝石版本|Pokemon - Version Saphir (F)
DORADORAWDBKA5GJ|骑龙少年|Dragon Drive - World D Break (J)
SHININGSOUL2AU2J|光明之魂2|Shining Soul II (J)
POKEMON RUBYAXVF|口袋妖怪红宝石版本|Pokemon - Version Rubis (F)
ALADDIN     AJ6J|迪斯尼-阿拉丁|Aladdin (J)
CT SPECIAL FA9CP|ＣＴ特种部队|CT Special Forces - Back to Hell (E)
PHANTASIA   AN8J|幻想传说|Tales of Phantasia (J)
POKEPIN R/S BPPJ|口袋妖怪弹珠台|Pokemon Pinball - Ruby & Sapphire (J)
DETECTIVE COAC4J|名侦探柯楠-被阻击的名侦探|Meitantei Conan - Nerawareta Tantei (J)
SRWD        A6SJ|超级机器人大战D|Super Robot Taisen D (J)
BATTLECHIPGPA89J|洛克人EXE-战斗芯片GP|Rockman EXE Battle Chip GP (J)
TGRALLY     AYEJ|顶级拉力赛车SP|Top Gear Rally (J)
CARDEREADER+PSAJ|卡片读取机|Card e-Reader+ (J)
DEBITIRUPUZLA8ZJ|真女神转生-恶魔之子|Shin Megami Tensei Devil Children - Puzzle de Call! (J)
WLDTHRNBRRYSAWTD|狂野丛林-猎杀黑猩猩|Expedition der Stachelbeeren - Zoff im Zoo (G)
SHREK 3     AOIE|史瑞克-恶臭大灾难|Shrek - Reekin' Havoc (U)
AGB-P-AZ3J  AZ3J|网络机械兽世纪|Cyberdrive Zoids - Kijuu no Senshi Hyuu (J)
DUEL MASTERSAA9J|游戏王-卡牌决斗高手|Duel Masters (J)
SAIYUUKI    BGMJ|幻想魔传最游记-叛逆的斗神太子|Gensou Maden Saiyuuki - Hangyaku no Toushin-taishi (J)
DOUBUTU     BWDJ|宠物医院-动物医生育成计划|Wan Nyan Doubutsu Byouin (J)
MADDEN NFL04BMDE|NFL橄榄球2004|Madden NFL 2004 (U)
MTM         BMTE|疯狂大脚车|Monster Truck Madness (UE)
DIGIMON BATTA8SP|数码暴龙|Digimon - Battle Spirit (E)
RRRACING    A4RP|摇滚赛车|Rock n' Roll Racing (E)
POKEPIN R/S BPPE|口袋妖怪弹珠台|Pokemon Pinball - Ruby & Sapphire (U)
SEIKEN SHIN1AVSJ|新约圣剑传说|Shinyaku Seiken Densetsu (J)
BO_BOBO2_GBABOBJ|爆裂鼻毛真拳|Boboboubo Boubobo - Maji de!! Shinken Battle (J)
MKTOURNAMENTAW4E|真人快打|Mortal Kombat - Tournament Edition (U)
M&M MAGICAL2AQMP|迪斯尼米老鼠2|Magical Quest 2 Starring Mickey & Minnie (E)
BILLY BLAZESAQHE|救援英雄-比利布雷斯|Rescue Heroes - Billy Blazes! (U)
FFTA_USVER. AFXE|最终幻想战略版|Final Fantasy Tactics Advance (UA)
DISNEY SKATEBESE|迪斯尼究级滑板|Extreme Skate Adventure (UE)
STAFY 2     AVFJ|传说的斯塔菲2|Densetsu no Stafy 2 (J)
GB JYAGAN   BGFJ|闪灵二人组-邪眼封印|GetBackers Dakkanya - Jagan Fuuin! (J)
FREEKSTYLE  BFSE|疯狂越野摩托|Freekstyle (U)
ROCKET_POWERAZZE|急速动力：零重力赛场|Rocket Power - Zero Gravity Zone (U)
PRNINJASTORMBPWE|金刚战士-武士风暴|Power Rangers - Ninja Storm (U)
STARSKYHUTCHAYHP|一路狂飚|Starsky & Hutch (E)
GEM SMASHERSAZSE|宝石也疯狂|Gem Smashers (U)
DENKIBLOCKS!ADBE|电击方块|Denki Blocks! (U)
NARUTOKONOHAAUEJ|火影忍者-木叶战记|Naruto - Konoha Senki (J)
BIONICLEGAMEBIOE|乐高荒岛探险|Bionicle (U)
SCOOBYMAYHEMBMME|史诺比鬼屋历险-隐秘的罪证|Scooby-Doo! - Mystery Mayhem (U)
BANJOKAZOOIEBKZE|琴音笛声-格兰蒂的复仇|Banjo-Kazooie - Grunty's Revenge (U)
ADVANCEWARS2AW2P|大战争2-黑洞的升起|Advance Wars 2 - Black Hole Rising (E)
GOLDEN_SUN_BAGFD|黄金太阳2-失落的时代|Golden Sun - Die vergessene Epoche (G)
OSYARE PRI3 BO3J|奥沙尔公主3|Oshare Princess 3 (J)
POLLY POCKETAOTP|波利口袋|Polly Pocket! (E)
DISNEY SKATEBESX|迪斯尼究级滑板|Extreme Skate Adventure (E)
MISTER NUTZ AZRP|松鼠大进攻|Mr Nutz (E)
BOKTAI      U3IE|我们的太阳|Boktai - The Sun Is in Your Hand (U)
GOLDEN_SUN_BAGFS|黄金太阳2-失落的时代|Golden Sun - La Edad Perdida (S)
GOLDEN_SUN_BAGFF|黄金太阳2-失落的时代|Golden Sun - L'Age Perdu (F)
KISEKAE2    AAJJ|新换装物语|Shin Kisekae Monogatari (J)
OJARUGEKKO  BOJJ|散步阿丸|Ojarumaru - Gekkouchou Sanpo de Ojaru (J)
CHOBIGURUMI A8DJ|狄尤小乖乖|Doubutsu Shima no Chobi Gurumi (J)
DISNEY PARTYBD8E|迪斯尼欢乐聚会|Disney's Party (UE)
BLACKTHORNE AQXE|黑色荆棘|Blackthorne (U)
TANTEI-Q    BTQJ|侦探学院Q-名侦探就是你|Tantei Gakuen Q - Meitantei ha Kimi da! (J)
DEBITIRUICE BDYJ|真女神转生-冰之书|Shin Megami Tensei Devil Children - Koori no Sho (J)
DEBITIRUFLAMBDHJ|真女神转生-炎之书|Shin Megami Tensei Devil Children - Honoo no Sho (J)
BARBIE      AI8E|巴比马术赛|Barbie Horse Adventures - Blue Ribbon Race (U)
ROADRASHJAILA9RE|暴力摩托|Road Rash - Jailbreak (U)
SIMPSONSRAGEA4AX|辛普森疯狂大道|Simpsons, The - Road Rage (E)
GOLDEN_SUN_BAGFI|黄金太阳2-失落的时代|Golden Sun - L'Era Perduta (I)
KOINU ISSYO BDIJ|爱情物语可爱的宠物小狗|Koinu to Issho - Aijou Monogatari (J)
PIGLET'SGAMEA9NX|小猪大游戏|Piglet's Big Game (E)
AGB KIRBY DXA7KP|星之卡比-梦之泉|Kirby - Nightmare in Dream Land (E)
JETFUSIONENGBJNE|杰米中子—喷射熔化|Adventures of Jimmy Neutron Boy Genius, The - Jet Fusion (UE)
RUGRATSGWILDA5WF|LES的大冒险|Razmoket Rencontrent les Delajungle, Les (F)
DIGIMON BS2 BDSE|数码宝贝精神大作战2|Digimon - Battle Spirit 2 (U)
BATTLEBOTSDDBBDE|机器人大战—设计与破坏|BattleBots - Design & Destroy (U)
JURASSICTOURAJ8J|侏罗纪公园创立旅行|Jurassic Park Institute Tour - Dinosaur Rescue (J)
MUNCH       BODE|奥蒂世界—奥蒂的咀嚼|Oddworld - Munch's Oddysee (UE)
B-DASH EX   ABDP|推石小子ＥＸ|Boulder Dash EX (E)
MEGA_EXE3_WHA6BP|洛克人网络战斗3-白|Megaman Battle Network 3 White (E)
DANGEROUS-G BZDJ|新流行物语|Zettaizetsumei Dangerous Jiisan - Shijou Saikyou no Dogeza (J)
DDS_2       A5TJ|真女神转生2|Shin Megami Tensei II (J)
SUPER MARIODAX4P|超级马里奥4|Super Mario Advance 4 - Super Mario Bros. 3 (E)
HOBBIT EU   AH9P|霍比特人|Hobbit, The (E)
BATTLE X2   BBFJ|战斗X战斗-巨大鱼传说|Battle X Battle - Kyodai Gyo Densetsu (J)
PIRATESCARIBA8QP|最终幻想战略版|Pirates of the Caribbean - The Curse of the Black Pearl (E)
FFTA_INTER. AFXP|加勒比海盗|Final Fantasy Tactics Advance (E)
LIONKING 1.5BLKE|迪斯尼狮子王1.5|Lion King 1 1-2, The (U)
BLACKTHORNE AQXP|黑色荆棘|Blackthorne (E)
QUAD DESFURYBQDE|沙漠狂暴人竞技赛|Quad Desert Fury (U)
NAMCOMUSEUM ANMP|南梦宫博物馆|Namco Museum (E)
BACKYARD HCYBYHE|冰球院场|Backyard Hockey (U)
CROUCHING TIAQDE|卧虎藏龙|Crouching Tiger, Hidden Dragon (U)
DEBITIRUYAMIAC5E|真女神转生-暗黑之书|DemiKids - Dark Version (U)
DEBITIRUHIKAAL4E|真女神转生-光明之书|DemiKids - Light Version (U)
BARBIE      AI8P|巴比马术赛|Barbie Horse Adventures (E)
MEGA_EXE3_BLA3XP|洛克人网络战斗3-蓝|Megaman Battle Network 3 Blue (E)
PICHIPICHI00BMAJ|日本少女—组合|Mermaid Melody - Pichi Pichi Pitch (J)
BOMBERMANJGCBOMJ|炸弹人杰特斯游戏竞技|Bomberman Jetters - Game Collection (J)
MEGAMANZERO2A62E|洛克人ZERO2|Megaman Zero 2 (U)
TAK&JUJUENG BJUE|塔克和符咒的神力|Tak and the Power of Juju (U)
MIRUMODEPON2BMPJ|神奇彩球对战|Wagamama Fairy Mirumo de Pon! - Taisen Mahoudama (J)
PET GALLERY BKGJ|可爱小狗游戏集合|Kawaii Pet Game Gallery (J)
MATANTEILOKIBMRJ|魔法侦探传奇—幻想之魔境|Matantei Loki Ragnarok - Gensou no Labyrinth (J)
SUPER MARIODAX4E|超级马里奥4|Super Mario Advance 4 - Super Mario Bros. 3 (U)
TMNT GBA    BNTE|忍者神龟|Teenage Mutant Ninja Turtles (U)
ORIENTALBLUEAORJ|天外魔境-青之天外|Oriental Blue - Ao no Tengai (J)
PRNINJASTORMBPWP|金刚战士-武士风暴|Power Rangers - Ninja Storm (E)
BANJOKAZOOIEBKZX|琴音笛声-格兰蒂的复仇|Banjo-Kazooie - Grunty's Revenge (E)
DYNAMIC     AVDJ|豪翔传-崩界的轮舞曲|Legend of Dynamic Goushouden - Houkai no Rondo (J)
SD_SUMOS_AGBBDPE|超级笨蛋相扑手|Super Duper Sumos (U)
BIONICLEGAMEBIOP|乐高荒岛探险|Bionicle (E)
DISNEY PRINCAQPF|迪士尼公主|Disney Princesse (F)
LIZZIEMCGUIRBLME|利兹在进行|Lizzie McGuire - On the Go! (U)
TGRALLY     BTGX|顶级拉力赛车SP|Top Gear Rally (E)
BATMAN-RISE BATE|蝙蝠侠-辛特组的复活|Batman - Rise of Sin Tzu (U)
LIONKING    BLKP|迪斯尼狮子王|Lion King, The (E)
SPYRO 3     AOWE|小龙斯派罗|Spyro - Attack of the Rhynocs (U)
THUGTHUGTHUGBTOE|托尼霍克地下滑板|Tony Hawk's Underground (UE)
OPERATION ALBAAE|反击！捍卫自由|Operation Armored Liberty (U)
MEGAMANZERO2A62P|洛克人Zero2|Megaman Zero 2 (E)
FROGGER RPG BFJE|青蛙的旅途|Frogger's Journey - The Forgotten Relic (U)
TGRALLY     BTGE|顶级拉力赛车SP|Top Gear Rally (U)
QUIDDITCH WCBHPE|哈里波特-魁地奇世界杯|Harry Potter - Quidditch World Cup (UE)
PRINCEPERSIABPYE|波斯王子-时之沙|Prince of Persia - The Sands of Time (U)
SBSPBATTLEBBBSQE|鲍勃斯邦奇-比基尼岛的冒险|SpongeBob SquarePants - Battle for Bikini Bottom (U)
BUKKAZOOM   AZHP|瓢虫汽车赛|Hugo - Bukkazoom! (E)
FIREEMBLEME AE7E|烈火之剑|Fire Emblem (UA)
RETURN KING BLRE|指环王-王者再临|Lord of the Rings, The - The Return of the King (UE)
POKEMON SAPPAXPE|口袋妖怪蓝宝石版本|Pokemon - Sapphire Version (E)
FIFA 2004   BFIE|FIFA足球2004|FIFA 2004 (UE)
SONICPINBALLA3VP|索尼克弹珠派对|Sonic Pinball Party (E)
YUGIOH DM7  AY7E|游戏王-神圣的卡片|Yu-Gi-Oh! - The Sacred Cards (U)
BROTHER BEARBBRE|迪斯尼小熊的兄弟们|Brother Bear (U)
POKEMON RUBYAXVE|口袋妖怪红宝石版本|Pokemon - Ruby Version (E)
FAIRLYODDAGBAF6E|正义双亲之叛逆的惩罚|Fairly Odd Parents!, The - Breakin' da Rules (U)
CATINTHEHAT AQTE|爱戴帽子的猫博士|Dr. Seuss' - The Cat in the Hat (U)
POKEPIN R/S BPPP|口袋妖怪弹珠台|Pokemon Pinball - Ruby & Sapphire (E)
MARIO&LUIGIPA88P|马里奥和路易-超巨星传说|Mario & Luigi - Superstar Saga (E)
MSS SHANGHAIBSHJ|上海|Minna no Soft Series - Shanghai (J)
YU-GI-OH DDMAYDP|游戏王-怪兽龙门骰|Yu-Gi-Oh! - Dungeon Dice Monsters (E)
TIGERWOODS04BTWE|泰戈伍兹2004PGA巡回赛|Tiger Woods PGA Tour 2004 (UE)
BUFFY       AVYF|吸血鬼杀手巴菲-返回黑暗世界|Buffy Contre les Vampires - La Colere de Darkhul (F)
SSX3        BSXE|疾风滑雪3|SSX 3 (UE)
PRINCEPERSIABPYP|波斯王子-时之沙|Prince of Persia - The Sands of Time (E)
BEYBLADE: ULBEYP|爆转陀螺王|Beyblade V-Force - Ultimate Blader Jam (E)
SURAIMUMORIMA9KJ|勇者斗恶龙之元气史莱姆-冲击的尾巴团|Slime Morimori Dragon Quest - Shougeki no Shippo Dan (J)
MIN_MAHJONGGBMJJ|全民麻将|Minna no Soft Series - Minna no Mahjong (J)
SANRIO PURO A85J|三丽鸥漫画全明星|Sanrio Puroland - All Characters (J)
ZOOO        BMZJ|动物饲养员|Minna no Soft Series - Zooo (J)
ONITAC1US   A6OE|鬼舞者战略版|Onimusha Tactics (U)
JUSTICE LEAGBJLE|正义联盟历代记|Justice League Chronicles (U)
CN SPEEDWAY ANRE|卡通网-高速飙车|Cartoon Network Speedway (U)
M&M MAGICAL2AQME|迪斯尼米老鼠2|Magical Quest 2 Starring Mickey & Minnie (U)
NITRO KART  BCNE|古惑狼赛车|Crash Nitro Kart (U)
ULTIMATE BEAAVEE|沙滩足球|Ultimate Beach Soccer (U)
HOBBIT US   AH9E|霍比特人|Hobbit, The (U)
SPIRITSPELLSAWNE|幽灵与符咒|Spirits & Spells (U)
DOUBLEDRAGONBDDE|双截龙|Double Dragon Advance (U)
SWORD OF MANAVSE|新约-圣剑传说|Sword of Mana (UA)
HARVESTMOGBAA4NE|牧场物语|Harvest Moon - Friends of Mineral Town (U)
FINDING NEMOAZIX|海底总动员|Finding Nemo (E)(Dut-Fre)
SPYRO 3     AOWP|小龙斯派罗|Spyro Adventure (E)
LOONEY TUNESBLTE|华纳明星总动员|Looney Tunes - Back in Action (UE)
M&D MAGICAL3BM3J|迪斯尼米老鼠和唐老鸭3|Mickey to Donald no Magical Quest 3 (J)
SPY KIDS IIIAV3P|间谍小子3-D|Spy Kids 3-D - Game Over (E)
KIM POSSIBLEAEYP|救世英雌|Kim Possible (E)[b]
BOND EON    BJBE|詹姆斯邦德007-谁与争锋|007 - Everything or Nothing (UE)
INFILTRATOR BMHE|荣誉勋章-渗透者|Medal of Honor - Infiltrator (UE)
MARIO&LUIGIUA88E|马里奥和路易-超巨星传说|Mario & Luigi - Superstar Saga (UA)
TERMINATOR 3AO3P|终结者3|Terminator 3 - Rise of the Machines (E)[b]
BEYBLADE: ULBEYE|爆转陀螺王|Beyblade V-Force - Ultimate Blader Jam (U)
TERMINATOR 3AO3E|终结者3|Terminator 3 - Rise of the Machines (U)
CIMATHEENEMYBCME|斯马-敌人|CIMA - The Enemy (U)
STARWARSFOTFBSWE|星球大战-飞行战队|Star Wars - Flight of the Falcon (U)
MARIO&LUIGIJA88J|马里奥和路易-超巨星传说|Mario & Luigi RPG (J)
STARWARSFOTFBSWP|星球大战-飞行战队|Star Wars - Flight of the Falcon (E)
QUIDDITCH WCBHPJ|哈里波特-魁地奇世界杯|Harry Potter - Quidditch World Cup (J)
SIMCITY 2000A5CP|模拟城市2000|Sim City 2000 (E)
MUCHA_LUCHA_BMLE|穆夏露萨-马卡三人组丢失的密码|Mucha Lucha! - Mascaritas of the Lost Code (U)
GREENEGGSHAMBUSE|苏斯博士之火腿加绿蛋|Green Eggs and Ham by Dr. Seuss (U)
POPIDOL     BIDE|美国偶像|American Idol (U)
TMNT GBA    BNTP|忍者神龟|Teenage Mutant Ninja Turtles (E)[b]
HOTWHEELS WRBHWE|火热飞轮-世界赛车|Hot Wheels - World Race (U)
F-ZERO2     BFZJ|零式赛车-猎鹰传说|F-Zero - Falcon Densetsu (J)
NITRO KART  BCNP|古惑狼赛车|Crash Nitro Kart (E)
GGENE A     BGAJ|SD高达G世纪|SD Gundam G-Generation Advance (J)
HOTWHEELS WOBHWP|火热飞轮-世界赛车|Hot Wheels - World Race (E)
MUNCH       BODD|阿比逃亡记-奇异世界|Oddworld - Munch's Oddysee (G)
DBZ TAIKETSUBDBE|龙珠Z-对决|Dragon Ball Z - Taiketsu (U)
CROUCHING TIAQDP|卧虎藏龙|Crouching Tiger, Hidden Dragon (E)
WORMSWORLDPTAWYE|百战天虫|Worms World Party (U)
DORA SUPER SBERE|探险家朵拉-超级间谍|Dora the Explorer - Super Spies (U)
PREMIER MAN BPMP|足球经理2003-04|Premier Manager 2003-04 (E)
MISSION IMPOAIHP|碟中谍-舍马行动|Mission Impossible - Operation Surma (E)
DINO2 DRAGONA4XJ|怪兽蛋2-龙|Gachasute! Dino Device 2 - Dragon (J)
DINO2 PHOENIA4WJ|怪兽蛋2-凤凰|Gachasute! Dino Device 2 - Phoenix (J)
ONITAC1EU   A6OP|鬼武者战略版|Onimusha Tactics (E)
LIZZIEMCGUIRBLMP|平民天后|Lizzie McGuire (E)[b]
PAWAPOKE6   BP6J|实况口袋野球6|Power Pro Kun Pocket 6 (J)
YUYUHAKUSHO1BYYE|幽游白书-灵界侦探|Yu Yu Hakusho - Ghostfiles - Spirit Detective (U)
SONICBATTLE BSBJ|索尼克战斗|Sonic Battle (J)
PAZUNINN    BPZJ|魔幻弹力球|Pazunin - Uminin no Puzzle de Nimu (J)
POPIDOL     BIDD|超巨星节拍|Deutschland sucht den Superstar (G)
THE SIMS ADVASIE|模拟人生-纯属意外|Sims, The - Bustin' Out (UE)
ACTANTHOLOGYBAVE|经典游戏合辑|Activision Anthology (U)
UWINTERGAMESBUWE|终极冬季运动会|Ultimate Winter Games (U)
G&W GALLERY4AQWE|游戏博物馆4|Game & Watch Gallery 4 (U)
OSANPO      BISJ|可爱小狗养育计划|Koinu-chan no Hajimete no Osanpo - Koinu no Kokoro Ikusei (J)
CINNAMON A  BPSJ|长耳狗-就在这里|Cinnamoroll - Koko ni Iru yo (J)
SITTING DUCKBSDP|坐坐鸭|Sitting Ducks (E)[b]
ROCK_EXE4_BMB4BJ|洛克人EXE4锦标赛-蓝月亮|Rockman EXE 4 - Tournament Blue Moon (J)
ROCK_EXE4_RSB4WJ|洛克人EXE4锦标赛-红太阳|Rockman EXE 4 - Tournament Red Sun (J)
PETER PAN   BPTE|小飞侠-电影版|Peter Pan - The Motion Picture Event (U)
SAKURA      BK3J|库洛魔法使-库洛的迷你游戏|Cardcaptor Sakura - Sakura Card de Mini Game (J)
GASH-ZAKERU A4GJ|魔界小金毛-共鸣!友情的电击|Konjiki no Gashbell!! - Unare! Yuujou no Zakeru (J)
BOKUMONOGBA BFGJ|牧场物语-矿石镇的伙伴们-女孩篇|Bokujou Monogatari - Mineral Town no Nakamatachi for Girl (J)
SPY MUPPETS BSSE|木偶间谍-特遣青蛙|Spy Muppets - License to Croak (U)
CROKET!3    B3KJ|馅饼3-砂糖王国之谜|Croket! 3 - Granu Oukoku no Nazo (J)
KITARO      BGKJ|鬼太郎-危机一发!妖怪列岛|Gegege no Kitarou - Kikiippatsu! Youkai Rettou (J)
KOFEX2HOWLINAEXE|格斗之王EX2-咆哮之血|King of Fighters EX2, The - Howling Blood (U)
MIRUMODEPON3BMYJ|任性妖精Mirumo-八目妖精|Wagamama Fairy Mirumo de Pon! - 8 Nin no Toki no Yousei (J)
RAREDKC1    A5NJ|超级大金刚|Super Donkey Kong (J)
FINDING NEMOBFNJ|海底总动员|Finding Nemo (J)
ASTROBOY    BTAJ|铁臂阿童木|Astro Boy - Tetsuwan Atom - Atom Heart no Himitsu (J)
DS_SNOWBD_U A5DE|迪斯尼全明星体育系列-滑雪板|Disney Sports - Snowboarding (U)
CRASH2      AC8J|古惑狼2|Crash Bandicoot Advance 2 - Gurugurusaimin Dai-Panic! (J)
MAX PAYNE   BMEE|马克思佩恩-英雄本色|Max Payne (U)
MSSTETRISADVBTTJ|俄罗斯方块|Minna no Soft Series - Tetris Advance (J)
OCHAKEN     BDRJ|小狗的窝|Ochaken no Heya (J)
NFSUG       BNSE|极品飞车-地下狂飙|Need for Speed Underground (UE)
SYLVANIA5   BS5J|妖精之杖-不可思议的大树|Sylvanian Families - Marron-inu no Onnanoko (J)
04:TP@2960  BS4J|休闲扑克2960第四集-王牌|The Trump - Minna de Asoberu 12 Shurui no Trump Game (J)
WAN TANTEI  BWMJ|汪汪名侦探|Wanwan Meitantei (J)
JOERED      BAMJ|小拳王-赤热之战|Ashita no Joe - Makka ni Moeagare! (J)
SIMCITY 2000A5CE|模拟城市2000|Sim City 2000 (U)
LEGO RACERS ALRP|乐高赛车2|LEGO Racers 2 (E)
ALTERED BEASAARP|兽王记-王国的守护者|Altered Beast - Guardian of the Realms (E)
TEKKEN ADVANATKP|铁拳|Tekken Advance (E)
KCEJ MINPRI BMOJ|大家的王子|Minna no Ouji-sama (J)
GEKIDO      AGEE|究级截拳道|Gekido Advance - Kintaro's Revenge (U)
WINTERSPORTSAWIP|ESPN盐湖城冬季奥运2002|ESPN International Winter Sports (E)
GODZILLA KDAAG4J|怪兽大乱斗|Godzilla - Kaijuu Dairantou Advance (J)
SONICBATTLE BSBE|战斗索尼克美版|Sonic Battle (U)
HYOUTANJIMA BHYJ|葫芦孤岛漂流记-大活跃之卷|Hyokkori Hyoutanjima - Don Gabacho Daikatsuyaku no Maki (J)
SHINING SOULAHUE|光明之魂|Shining Soul (U)
FREEKSTYLE  BFSP|疯狂越野摩托|Freekstyle (E)
ROADRASHJAILA9RP|暴力摩托|Road Rash - Jailbreak (E)
BALDURSGATE BGDE|博得之门|Baldur's Gate - Dark Alliance (U)
GYAKUTEN_SA3A3JJ|逆转裁判3|Gyakuten Saiban 3 (J)
TTA-WACKY   AWSE|顽皮兔大冒险-古怪蛋方块|Tiny Toon Adventures - Wacky Stackers (U)
THE SIMS ADVB4PJ|模拟人生-纯属意外|Sims, The (J)
POKEMON FIREBPRJ|口袋妖怪-火红|Pocket Monsters - Fire Red (J)
S BUBBLE POPAVZP|超级泡泡|Super Bubble Pop (E)
POKEMON LEAFBPGJ|口袋妖怪-叶绿|Pocket Monsters - Leaf Green (J)
SCOOBYMAYHEMBMMP|史诺比鬼屋历险-隐秘的罪证|Scooby-Doo! - Mystery Mayhem (E)
YUGIOH DM7  AY7P|游戏王-神圣的卡片|Yu-Gi-Oh! - The Sacred Cards (E)
BROTHER BEARBBRX|迪斯尼小熊的兄弟们|Brother Bear (E)
YUGIOHDMEX3 BY3J|游戏王EX3|Yu-Gi-Oh! - Duel Monsters Expert 3 (J)
SBSPBATTLEBBBSQP|鲍勃斯邦奇-比基尼岛的冒险|SpongeBob SquarePants - Battle for Bikini Bottom (E)
BALDURSGATE BGDP|博得之门|Baldur's Gate - Dark Alliance (E)
MR. DRILLER2AD2P|钻地先生２|Mr. Driller 2 (E)
ZEROMISSIONEBMXE|银河战士之零点任务|Metroid - Zero Mission (U)
PUYO POP    APYP|魔法气泡大会战|Puyo Pop (E)[b]
DISNEY PRINCAQPI|迪士尼公主|Disney Principesse (I)
CORVETTE    AVCE|雪佛莱50周年纪念|Corvette (U)
OZZY&DRIX   BOZE|捍卫战士|Ozzy & Drix (U)
PICHIPICHI2 BM8J|美人鱼之韵律|Mermaid Melody - Pichi Pichi Pitch - Pichi Pichi Party (J)
JET SET RADIAJRP|喷射小子之街头涂鸦|Jet Set Radio (E)[b]
NEEDFORSPEEDAZFP|极品飞车-宝时捷之旅|Need for Speed - Porsche Unleashed (E)
YWCT2004USA BYWE|游戏王之世界锦标赛2004|Yu-Gi-Oh! - World Championship Tournament 2004 (U)
CT SPECIAL FAC7E|CT特种部队|CT Special Forces (U)
BRUCE LEE   ALEE|李小龙之英雄再现|Bruce Lee - Return of the Legend (U)
ICE CLIMBER FICJ|任天堂FC珍藏游戏之超级玛丽|Famicom Mini Vol. 03 - Ice Climber (J)
XEVIOUS     FXVJ|任天堂FC珍藏游戏之敲冰块|Famicom Mini Vol. 07 - Xevious (J)
SUPER MARIO FSMJ|任天堂FC珍藏游戏之铁板阵|Famicom Mini Vol. 01 - Super Mario Bros. (J)
PITFALL     BPHP|玛亚历险记之迷失的探险队|Pitfall - The Lost Expedition (E)
DONKEY KONG FDKJ|任天堂FC珍藏游戏之大金刚|Famicom Mini Vol. 02 - Donkey Kong (J)
ZELDA 1     FZLJ|任天堂FC珍藏游戏之赛尔达|Famicom Mini Vol. 05 - Zelda no Densetsu 1 (J)
MAPPY       FMPJ|任天堂FC珍藏游戏之猫捉老鼠|Famicom Mini Vol. 08 - Mappy (J)
CHESSMASTER ACYD|西洋棋大师|Chessmaster (G)[b]
HARVESTMOGERA4ND|牧场物语之矿石镇的朋友|Harvest Moon - Friends of Mineral Town (G)[b]
STAR SOLDIERFSOJ|任天堂FC珍藏游戏之星际战士|Famicom Mini Vol. 10 - Star Soldier (J)
EXCITEBIKE  FEBJ|任天堂FC珍藏游戏之电单车|Famicom Mini Vol. 04 - Excitebike (J)
BOMBER MAN  FBMJ|任天堂FC珍藏游戏之炸弹人|Famicom Mini Vol. 09 - Bomberman (J)
PAC-MAN     FPMJ|任天堂FC珍藏游戏之吃豆子|Famicom Mini Vol. 06 - Pac-Man (J)
PETER PAN   BPTP|小飞侠电影版|Peter Pan - The Motion Picture Event (E)
PITFALL     BPHF|玛亚历险记-迷失的探险队|Pitfall - L'Expedition Perdue (F)
FINDING NEMOAZIY|海底总动员|Finding Nemo (E)(Ita-Spa)
GAKUENMURYOUBGSJ|学院战记|Gakuen Senki Muryou (J)
BANJOKAZOOIEBKZI|琴音笛声-格兰蒂的复仇|Banjo-Kazooie - La Vendetta di Grunty (I)
MONSTERS INCAMXX|怪兽电力公司|Monsters, Inc. (E)(Dut-Eng-Spa)
DOWNTOWN    BDTJ|热血物语EX|Downtown Nekketsu Monogatari EX (J)
ATARI ANNIVEAAVP|雅利达游戏合集|Atari Anniversary Advance (E)
SNOOD       ASQP|怪投射波|Snood (E)
BATTLECHIPGPA89E|洛克人芯片战斗|Megaman Battle Chip Challenge (U)
ULTRAMAN    BU6J|激斗英雄奥特曼|Taiketsu! Ultra Hero (J)
PDA4AGB     PDA1|个人商务PDA|GBA Personal Organizer (U)(Unl)
GGXAE       AGXE|罪恶克星Ｘ|Guilty Gear X - Advance Edition (U)
SHINING SOULAU2P|光明之魂2|Shining Soul II (E)
PANDORATOMORBSLP|分裂细胞：明日潘多拉|Tom Clancy's Splinter Cell - Pandora Tomorrow (E)
ONEPIEBASEBAB08J|海贼王：热血棒球|One Piece - Going Baseball - Kaizoku Yakyuu (J)
ALADDIN     BADP|迪斯尼-阿拉丁|Aladdin (E)
POPIDOL     BIDP|流行偶像|Pop Idol (E)
SABREWULFTHQAWUP|剑齿虎|Sabre Wulf (E)
TAK&JUJUMULTBJUP|塔克和符咒的神力|Tak and the Power of Juju (E)
THE CAT IN TAQTP|爱戴帽子的猫博士|Dr. Seuss' - The Cat in the Hat (E)
SWORD OF MANAVSX|新约-圣剑传说|Sword of Mana (E)(Fre-Ger)
YUGIOU SUGO BYSJ|游戏王双六的骰子|Yu-Gi-Oh! - Sugoroku no Sugoroku (J)
SCOOBY-DOO_2BMUE|史酷比2脱缰的怪物|Scooby-Doo 2 - Monsters Unleashed (UE)
RTYPE III   BR3E|神龙传3|R-Type III - The Third Lightning (U)
BATTLECHIPGPA89P|洛克人EXE-战斗芯片GP|Megaman Battle Chip Challenge (E)
DRAGON BALLZBDBP|龙珠Z-对决|Dragon Ball Z - Taiketsu (E)
MAX ADVANCE BMEP|马克思·佩恩|Max Payne Advance (E)
SWORD OF MANAVSY|新约-圣剑传说|Sword of Mana (E)(Ita-Spa)
M&D MAGICAL3BMQP|迪斯尼米老鼠和唐老鸭3|Magical Quest 3 Starring Mickey & Donald (E)
WADE HIXTONSBSRE|维德·汉克斯的反击|Wade Hixton's Counter Punch (UE)
TANTEI-Q2   BTIJ|侦探学园Q|Tantei Gakuen Q - Kyuukyoku Trick ni Idome! (J)
PICHIPICHI02B3MJ|美人鱼之韵律|Mermaid Melody - Pichi Pichitto Live Start! (J)
DRAGONBLBKTGAZJJ|龙珠Z之空舞斗剧|Dragon Ball Z - Bukuu Tougeki (J)
DOUBLEDRAGONBDDJ|双截龙|Double Dragon Advance (J)
03:IP@2960  BS3J|简单2960系列3之依特苏德姆方块|The Itsudemo Puzzle - Massugu Soroeru Straws (J)
HAGANERONDO BHRJ|钢之炼金术士迷走之轮舞曲|Hagane no Renkinjutsushi - Meisou no Rondo (J)
FRANKLIN    BFKP|海龟富兰克林|Franklin the Turtle (E)
HARVESTMOGBAA4NP|牧场物语|Harvest Moon - Friends of Mineral Town (E)
PPG MOJOGOGOAPTP|飞天小女警-魔人啾啾|Powerpuff Girls, The - Mojo Jojo A-Go-Go (E)
DLDEESASTER ADLP|德克斯特的实验室|Dexter's Laboratory - Deesaster Strikes! (E)
YWCT2004EUR BYWP|游戏王-世界锦标赛2004|Yu-Gi-Oh! - World Championship Tournament 2004 (E)
JUNGLE BOOK AJFE|迪斯尼丛林之书|Jungle Book, The (U)
STREETJAM   A3ZE|街头篮球|Street Jam Basketball (UE)
DUELMASTERS2BD2J|怪兽大决斗2|Duel Masters 2 - Invincible Advance (J)
LILLIPUT    BRPJ|小人国历险记|Lilliput Oukoku - Lillimoni to Issho Puni! (J)
BO_BOBO3_GBABB9J|鼻毛传说|Boboboubo Boubobo - 9 Kyoku Senshi Gag Yuugou (J)
DIGIMONRACINBDJJ|数码宝贝赛车|Digimon Racing (J)
ANIMAL SNAP AAQE|动物方块-拯救它们|Animal Snap - Rescue Them 2 By 2 (U)
DAVID BECKHAABQE|贝克汉姆足球|David Beckham Soccer (U)
ANTZ RACING ANUE|小蚁雄兵之终极赛车|Antz - Extreme Racing (U)
CT SPECIAL FBC3P|CT特种部队3|CT Special Forces - Bioterror (E)
DEMON DRIVERA9AE|魔鬼赛车手之燃烧的时间|Demon Driver - Time to Burn Rubber! (U)
MIMPOSSIBLE AIHE|不可能的任务之苏尔玛指令|Mission Impossible - Operation Surma (U)
DISNEY HOTR BHME|牧场是我家|Home on the Range (U)
SOUND OF THUA3QP|雷霆之声|Sound of Thunder, A (E)
ICE NINE    AR3E|冰冻九号|Ice Nine (UE)
SCOOBY DOO 2BMUX|史努比2-怪兽出笼|Scooby-Doo 2 - Monsters Unleashed (E)
ZEROMISSIONPBMXP|银河战士之最初任务|Metroid - Zero Mission (E)
NA-SU       BPNJ|亮丽护士物语-活泼护士养成游戏|Pikapika Nurse Monogatari - Nurse Ikusei Game (J)
AGB KIRBY AMB8KJ|星之卡比-镜之谜宫|Hoshi no Kirby - Kagami no Daimeikyuu (J)
FIGHTBOX    BOXP|格斗大会|FightBox (E)
BOOKWORM    BKWE|书虫|Bookworm (U)[b]
ROCKMANZERO3BZ3J|洛克人Zero3|Rockman Zero 3 (J)
MARIOGOLFGBABMGJ|马里奥高尔夫巡回赛|Mario Golf - GBA Tour (J)
ROADTRIPSHIFA6RE|变速齿轮-公路旅行|Road Trip - Shifting Gears (U)
SHININGSOUL2AU2E|光明之魂2|Shining Soul II (U)
SAKURA001MTOBKSJ|库洛魔法使-卡片朋友|Cardcaptor Sakura - Sakura to Card to Otomodachi (J)
VIOLENCE-K  BZGJ|天才爷爷2|Zettaizetsumei Dangerous Jiisan - Wagahai ga 1ban Erainjai!! (J)
STELLVIA_GBABUVJ|宇宙学院|Uchuu no Stellvia (J)
PIA33       BP3J|绯色茶餐厅|Pia Carrot he Youkoso!! 3.3 (J)
SERIOUS SAM AENE|英雄萨姆A|Serious Sam Advance (U)
TENPINALLEY2BTPE|大满贯保龄球|Ten Pin Alley 2 (U)
DIGIMONRACINBDGP|数码暴龙赛车|Digimon Racing (E)
SUPER CLPSE2BCLE|坍塌方块|Super Collapse! II (U)
NARUTO ACT2 BN2J|火影忍者-最强忍者大集合2|Naruto - Saikyou Ninja Daikesshuu 2 (J)
SHININGFORCEAF5P|光明力量-暗黑龙的复活|Shining Force - Resurrection of the Dark Dragon (E)
RETURN KING BLRJ|指环王-王者归来|Lord of the Rings, The - Ou no Kikan (J)
NETSAL      ANVJ|风来西林怪兽足球|Shiren Monsters Netsal (J)
KCEJ TP2K4S B4SJ|网球王子-荣耀之金|Tennis no Ouji-sama 2004 - Stylish Silver (J)
KCEJ TP2K4G B4GJ|网球王子-时尚之银|Tennis no Ouji-sama 2004 - Glorious Gold (J)
JAGUAR      BPBJ|眼睛君|Pyuu to Fuku! Jaguar - Byoo to Deru! Megane-kun (J)
ONPI7TSUJIMAAO7K|海贼王-七岛大秘宝|One Piece - Ilgop Seomui Debomool (K)
SHREK 2     BSEE|史瑞克2|Shrek 2 (UE)
VAN HELSING BANE|范海辛|Van Helsing (U)
KURESHIN2004BKCJ|蜡笔小新-电影乐园大冒险|Crayon Shin-chan - Arashi wo Yobu Cinema Land no Daibouken! (J)
SERIOUS SAM AENP|英雄萨姆A|Serious Sam Advance (E)
STEELEMPIRE BKTJ|钢铁帝国|Koutetsu Teikoku from HOT-B (J)
GUNDAMSEED  BGNJ|机动战士高达SEED-友情篇|Kidou Senshi Gundam Seed - Tomo to Kimi to Koko de. (J)
BOKTAI      U3IP|我们的太阳|Boktai - The Sun Is in Your Hand (E)
VAN HELSING BANP|范海辛|Van Helsing (E)
SPONGEBOB 01MSSE|超级海绵第1卷|SpongeBob SquarePants - Volume 1 (U)
SPONGEBOB 02MS2E|超级海绵第2卷|SpongeBob SquarePants - Volume 2 (U)
FAIRLYODD 02MF2E|反斗家族第2卷|Fairly Odd Parents!, The - Volume 2 (U)
BOND EON    BJBJ|007-谁与争锋|007 - Everything or Nothing (J)
MARIOVSDK   BM5E|马里奥对大金刚|Mario vs. Donkey Kong (UA)
SONICADVANC3B3SE|索尼克3|Sonic Advance 3 (U)
GADGETRACERSAQ2P|迷你赛车|Gadget Racers (E)
TWINBEE     FTWJ|任天堂FC珍藏游戏系列第19辑|Famicom Mini Vol. 19 - Twin Bee (J)
BALLOONFIGHTFBFJ|任天堂FC珍藏游戏系列第13辑|Famicom Mini Vol. 13 - Balloon Fight (J)
MAKAIMURA   FMKJ|任天堂FC珍藏游戏系列第18辑|Famicom Mini Vol. 18 - Makaimura (J)
DIG DUG     FDDJ|任天堂FC珍藏游戏系列第16辑|Famicom Mini Vol. 16 - Dig Dug (J)
MARIO BROS. FMBJ|任天堂FC珍藏游戏系列第11辑|Famicom Mini Vol. 11 - Mario Bros. (J)
BOKENJIMA 1 FTBJ|任天堂FC珍藏游戏系列第17辑|Famicom Mini Vol. 17 - Takahashi Meijin no Boukenjima (J)
GOEMON 1    FGGJ|任天堂FC珍藏游戏系列第20辑|Famicom Mini Vol. 20 - Ganbare Goemon! Karakuri Douchuu (J)
WRECKINGCREWFWCJ|任天堂FC珍藏游戏系列第14辑|Famicom Mini Vol. 14 - Wrecking Crew (J)
DR. MARIO   FDMJ|任天堂FC珍藏游戏系列第15辑|Famicom Mini Vol. 15 - Dr. Mario (J)
CLU CLU LANDFCLJ|任天堂FC珍藏游戏系列第12辑|Famicom Mini Vol. 12 - Clu Clu Land (J)
RIVERCRANSOMBDTE|热血物语EX|River City Ransom EX (U)
HARRY POTTERBHTE|哈利波特与阿兹卡班的逃犯|Harry Potter and the Prisoner of Azkaban (UE)
FUJUHOUROKU BTFJ|东京魔人学院-符咒封禄|Tokyo Majin Gakuen - Fuju Houroku (J)
DOREXPLOR 01MDRE|GBA电影-小冒险家朵拉第1卷|Dora the Explorer - Volume 1 (U)
MBEANZPP    BMBE|豆仔口袋方块|Mighty Beanz Pocket Puzzles (U)
SONIC X   01MSHE|GBA电影-音速小子X第1卷|Sonic X - Volume 1 (U)
F-ZERO2     BFZP|零式赛车-猎鹰传说|F-Zero - GP Legend (E)
CRASH PURPLEBD4E|古惑狼-发怒的瑞皮托|Crash Bandicoot Purple - Ripto's Rampage (U)
SPYRO ORANGEBSTE|宝贝龙-库泰斯的阴谋|Spyro Orange - The Cortex Conspiracy (U)
DM SEMPAI   AA9E|决斗领主：萨姆派传说|Duel Masters - Sempai Legends (U)
ZELDA 1     FZLE|经典任天堂-塞尔达传说|Classic NES Series - Legend of Zelda (UE)
SONIC BATTLEBSBP|索尼克战斗|Sonic Battle (E)
SUPER MARIO FSME|经典任天堂-超级马里奥兄弟|Classic NES Series - Super Mario Bros. (UE)
STRAWBERRY01MSBE|GBA电影-蛋糕上的草莓第1卷|Strawberry Shortcake - Volume 1 (U)
BOMBER MAN  FBME|经典任天堂-炸弹人|Classic NES Series - Bomberman (UE)
EXCITEBIKE  FEBE|经典任天堂-越野机车|Classic NES Series - Excitebike (UE)
XEVIOUS     FXVE|经典任天堂-铁板阵|Classic NES Series - Xevious (UE)
PAC-MAN     FP7E|经典任天堂-大食客|Classic NES Series - Pac-Man (UE)
ICE CLIMBER FICE|经典任天堂-雪人兄弟|Classic NES Series - Ice Climber (UE)
DONKEY KONG FDKE|经典任天堂-大金刚|Classic NES Series - Donkey Kong (UE)
FAIRLYODD 01MFOE|GBA电影-反斗家族第1卷|Fairly Odd Parents!, The - Volume 1 (U)
UCG         BUCE|终极卡片游戏|Ultimate Card Games (UE)
ALLGROWNUP01MGUE|GBA电影-成长第1卷|All Grown Up - Volume 1 (U)
SHINJAJA    BNJJ|茶茶丸Jr.传承记|Jajamaru Jr. Denshouki - Jalecolle mo Arisourou (J)
MARIOVSDK   BM5J|马里奥对大金刚|Mario vs. Donkey Kong (J)
ZEROMISSIONJBMXJ|银河战士-零点任务|Metroid - Zero Mission (J)
INFILTRATOR BMHJ|荣誉勋章-渗透者|Medal of Honor Advance (J)
SABREWULFTHQAWUE|剑齿虎|Sabre Wulf (U)
SHININGFORCEAF5E|光明力量-暗黑龙的复活|Shining Force - Resurrection of the Dark Dragon (U)
POCKETRESORTBM4J|米老鼠-口袋旅游胜地|Mickey no Pocket Resort (J)
WARIOLANDE  AWAC|瓦力欧寻宝记|Waliou Xunbao Ji (C)
WWCC5       AWWE|啄木鸟伍迪勇闯疯狂城堡5|Woody Woodpecker in Crazy Castle 5 (U)
XS MOTO     BXME|XS摩托|XS Moto (U)
THUNDERALLEYBTHE|雷霆越野|Thunder Alley (U)
SONICADVANC3B3SJ|索尼克3|Sonic Advance 3 (J)
ASTERIX     BLXP|幻想新国度|Asterix & Obelix XXL (E)
SHREK 2     BSEX|史瑞克2|Shrek 2 (E)
SECRETAGENTBAAHP|芭比秘密间谍|Secret Agent Barbie - Royal Jewels Mission (E)
RAREDKC2    B2DP|超级大金刚2|Donkey Kong Country 2 (E)
SONIC ADVANCB3SP|索尼克3|Sonic Advance 3 (E)
SPYRO ORANGEBSTP|宝贝龙-橙|Spyro Fusion (E)
CRASH PURPLEBD4P|古惑狼-紫|Crash Bandicoot Fusion (E)
MARIOGOLFGBABMGE|马里奥高尔夫巡回赛|Mario Golf - Advance Tour (U)
AGB-TORNEKO3BD3J|特鲁尼克大冒险3-不思议的迷宫|Torneco no Daibouken 3 Advance - Fushigi no Dungeon (J)
HARRY POTTERBHTJ|哈利波特与阿兹卡班的逃犯|Harry Potter to Azkaban no Shuujin (J)
CHINESE1&2  BSAJ|超级中国人1-2|Super Chinese 1-2 Advance (J)
DRAGONBLSSWUAZJE|龙珠Z-舞空斗剧|Dragon Ball Z - Supersonic Warriors (U)
POKEGBAVID02MPBE|GBA电影-口袋妖怪第2卷|Pokemon - Volume 2 (U)
POKEGBAVID01MPAE|GBA电影-口袋妖怪第1卷|Pokemon - Volume 1 (U)
BBBALL      A8LJ|BB球　　　　　|BB Ball (J)
OSHAREWANKO A5SJ|俏皮宠物|Oshare Wanko (J)
SPIDER-MAN2 BSPE|蜘蛛侠2|Spider-Man 2 (UE)
MEGAMANBN4RSB4WE|洛克人EXE4红日|Megaman Battle Network 4 Red Sun (U)
MEGAMANBN4BMB4BE|洛克人网络战斗4-蓝月|Megaman Battle Network 4 Blue Moon (U)
YUGIOH DM8  AY8E|游戏王8-毁灭的大邪神|Yu-Gi-Oh! - Reshef of Destruction (U)
CARTOONNET01MCTE|GBA电影-卡通频道珍藏电影第1卷|Cartoon Network Collection - Volume 1 (U)
KIDSNEXTDO01MKDE|GBA电影-小孩大联邦第1卷|Codename Kids Next Door - Volume 1 (U)
RAREDKC2    B2DJ|超级大金刚2|Super Donkey Kong 2 (J)
AGB KIRBY AMB8KP|星之卡比-镜之谜宫|Kirby & the Amazing Mirror (E)
NICKTOONS 01MNCE|GBA电影-尼克卡通珍藏电影第1卷|Nicktoons Collection - Volume 1 (U)
AROUND THE WB8DE|环游世界80天|Around the World in 80 Days (U)
KIMPOSSIBLE2BKME|迪斯尼之麻辣女孩2|Kim Possible 2 - Drakken's Demise (U)
JIMMYNEUTR01MJME|GBA电影-天才小子吉米大冒险第1卷|Adventures of Jimmy Neutron Boy Genius, The - Volume 1 (U)
SPIDER-MAN2 BSPX|蜘蛛侠2|Spider-Man 2 (E)
MARIOGOLFGBABMGU|马里奥高尔夫巡回赛|Mario Golf - Advance Tour (A)
SITTING DUCKBSDE|坐坐鸭|Sitting Ducks (U)
CT SPECIAL FA9CE|CT特种部队2-重返战壕|CT Special Forces 2 - Back in the Trenches (U)
ASTROBOY    BTAE|铁臂阿童木-阿童木心之秘密|Astro Boy - Omega Factor (U)
HAMSPORTS   B85A|哈姆太郎运动会|Hamtaro - Ham-Ham Games (JU)
ZORORIOHIME BKOJ|恶作剧王大闹魔法游乐园|Kaiketsu Zorori to Mahou no Yuuenchi - Ohimesama wo Sukue! (J)
DANGEROUS-G2BZ2J|天才爷爷-痔疮先生的痛|Zettaizetsumei Dangerous Jiisan Tsuu - Ikari no Oshioki Blues(J)
DC2         BDKJ|便利商店2-打倒熊猫少女团|Digi Communication 2 - Datou! Black Gemagema Dan (J)
FIREEMBLEMX AE7X|火炎之纹章[法/德]|Fire Emblem (E)
FIREEMBLEMY AE7Y|火炎之纹章[意/西]|Fire Emblem (E)
MIRUMODEPON4BWFJ|任性妖精米诺-梦的碎片|Wagamama Fairy Mirumo de Pon! - Yume no Kakera (J)
HAMSPORTS   B85P|哈姆太郎运动会|Hamtaro - Ham-Ham Games (E)
TMNT 01     MTME|GBA电影-忍者神龟第1卷|Teenage Mutant Ninja Turtles - Volume 1 (U)
DOOM II     A9DP|毁灭战士2|Doom II (E)
GASHBOOKMARKBKBJ|金色卡修-魔界的书签|Konjiki no Gashbell!! - Makai no Bookmark (J)
M.SUMMONER  A3NJ|怪兽召唤士|Monster Summoner (J)
YUGIOH 01   MYGE|GBA电影-游戏王第1卷|Yu-Gi-Oh! - Volume 1 (U)
NARUTORPG   BNRJ|火影忍者RPG|Naruto RPG - Uketsugareshi Hi no Ishi (J)
CATWOMAN    BCWE|猫女|Catwoman (UE)
ZOKTAI      U32J|我们的太阳续集-太阳少年加戈|Zoku Bokura no Taiyou - Taiyou Shounen Django (J)
DUELMASTER25BD5J|卡片决斗高手2-切札胜舞版|Duel Masters 2 - Kirifuda Shoubu Ver. (J)
HAGANESONATABH2J|钢之炼金术士-回忆之奏鸣曲|Hagane no Renkinjutsushi - Omoide no Sonata (J)
CROKET!4    BK4J|馅饼4-森林守护神|Croket! 4 - Bank no Mori no Mamorigami (J)
AMDRIVERHEROBGIJ|重装骑士-闪光英雄的诞生|Get Ride! Amdriver - Senkou no Hero Tanjou! (J)
SUPER MARIOAAMAC|超级马里欧2中文版|Chaoji Maliou 2 (C)
DBZLGCYGOKU2ALFJ|龙珠Z-悟空的遗产2国际版|Dragon Ball Z - The Legacy of Goku II International (J)
PUYO FEVER  BPFJ|魔法气泡大会战|Puyo Puyo Fever (J)
KAIDAN      BGHJ|学校怪谈－百宝箱之封印|Gakkou no Kaidan - Hyakuyoubako no Fuuin (J)
ZERO ONE SP BZOJ|对与错SP|Zero One SP (J)
PAWAPOKE1&2 B8PJ|实况口袋1+2|Power Pro Kun Pocket 1-2 (J)
LEGENDZSHIMABLJJ|LEGENDZ～复苏的试练之岛|Legendz - Yomigaeru Shiren no Shima (J)
FF1&2ADVANCEBFFJ|最终幻想I+II|Final Fantasy I - II Advance (J)
DRAGONTALES BD9E|神龙传说龙之冒险|Dragon Tales - Dragon Adventures (U)
TAK&JUJUMULTBJUX|塔克和符咒的神力|Tak and the Power of Juju (E)
HANADON     BDAJ|花火百景A|Donchan Puzzle Hanabi de Dohn Advance (J)
HYAKEI      BHAJ|花火大会|Hanabi Hyakkei Advance (J)
SDGFORCE    BG4J|SD高达力量|SD Gundam Force (J)
SHININGFORCEAF5J|光明力量-暗黑龙的复活|Shining Force - Kuroki Ryuu no Fukkatsu (J)
ROCKEXE4.5ROBR4J|洛克人4.5-真实演习|Rockman EXE 4.5 - Real Operation (J)
CHOBIGURUMI2BDCJ|动物岛的乔比们2-球球物语|Doubutsu Shima no Chobi Gurumi 2 - Tama-chan Monogatari (J)
BB-DAMANFIREBDXJ|碰球传说|B-Densetsu! Battle B-Daman - Moero! B-Tamashii! (J)
HIMAWARI    BNBJ|向日葵动物医院-宠物医生|Himawari Doubutsu Byouin - Pet no Oishasan Ikusei Game (J)
ULTRAGUARDMABUTJ|超级警备队-怪兽袭击|Ultra Keibitai - Monster Attack (J)
STAFY 3     B3DJ|传说的斯塔菲3|Densetsu no Stafy 3 (J)
NEEDFORSPEEDAZFE|极品飞车之保时捷|Need for Speed - Porsche Unleashed (U)
CNBLOCKPARTYAC9E|卡通网-街区聚会|Cartoon Network Block Party (U)
GUNDAMSEED-BBGNE|高达战袭|Mobile Suit Gundam Seed - Battle Assault (U)
MADDEN 2005 BMFE|NFL橄榄球2005|Madden NFL 2005 (U)
THUNDERBIRDSBTBE|雷鸟|Thunderbirds (UE)
SUPER MARIO2FM2J|任天堂FC珍藏游戏系列第21辑|Famicom Mini Vol. 21 - Super Mario Bros. 2 (J)
MURASAME    FNMJ|任天堂FC珍藏游戏系列第22辑|Famicom Mini Vol. 22 - Nazo no Murasame Jou (J)
FMS METROID FMRJ|任天堂FC珍藏游戏系列第23辑|Famicom Mini Vol. 23 - Metroid (J)
PARTHENA    FPTJ|任天堂FC珍藏游戏系列第24辑|Famicom Mini Vol. 24 - Hikari Shinwa - Palthena no Kagami (J)
LINK        FLBJ|任天堂FC珍藏游戏系列第25辑|FC Mini Vol. 25 - The Legend of Zelda 2 - Link no Bouken (J)
ONIGASHIMA  FFMJ|任天堂FC珍藏游戏系列第26辑|FC Mukashi Banashi - Shin Onigashima - Zen Kou Hen (J)
TANTEI CLUB1FTKJ|任天堂FC珍藏游戏系列第27辑|FC Vol. 27 - FC Tantei Club - Kieta Koukeisha - Zen Kou Hen (J)
TANTEI CLUB2FTUJ|任天堂FC珍藏游戏系列第28辑|FC Tantei Club II - Ushiro ni Tatsu Shoujo - Zen Kou Hen (J)
DRACULA 1   FADJ|任天堂FC珍藏游戏系列第29辑|Famicom Mini Vol. 29 - Akumajou Dracula (J)
SD GACHAPON1FSDJ|任天堂FC珍藏游戏系列第30辑|FC 30 - SD Gundam World - Gachapon Senshi Scramble Wars (J)
SBSPMOVIE   BSNE|GBA电影-超级海绵电影版|SpongeBob SquarePants Movie, The (U)
TOM CLANCY'SBSLE|分裂细胞：明日潘多拉　　　　　　　　|Tom Clancy's Splinter Cell - Pandora Tomorrow (U)
PITFALL     BPHE|玛亚历险记-迷失的探险队|Pitfall - The Lost Expedition (U)
DRAGONBLSSWEAZJP|龙珠Z-超音速战斗|Dragon Ball Z - Supersonic Warriors (E)
CRAFTSWORD2 BSKJ|召唤之夜-铸剑物语2|Summon Night - Craft Sword Monogatari 2 (J)
MARIO BALL  BMVJ|马里奥弹珠台|Super Mario Ball (J)
SUPER MARIODAX4P|超级马力奥4|Super Mario Advance 4 - Super Mario Bros. 3 (E)
NITRO KART  BCNJ|CrashBandicoot-Bakusou!NitroCart(J)|Crash Bandicoot Bakusou Nitro Cart (J)
DIGIMONRACINBDGE|数码暴龙赛车|Digimon Racing (U)
RAPALA PRO FBRFE|诺马职业钓鱼|Rapala Pro Fishing (UE)
CRUSHED BASEBCBE|热血棒球|Crushed Baseball (U)
POKEMON FIREBPRE|口袋妖怪-火红|Pokemon - Fire Red Version (U)
POKEMON LEAFBPGE|口袋妖怪-叶绿|Pokemon - Leaf Green Version (U)
PRDINOTHUNDEBPOE|鸟人战队-巨龙雷鸣|Power Rangers - Dino Thunder (UE)
MEGAMANZERO3BZ3P|洛克人Zero3|Megaman Zero 3 (E)
TETRISWORLDSATWY|俄罗斯方块世界|Tetris Worlds (E)
FINDINGNEMO2BZIE|海底总动员-连续冒险|Finding Nemo - The Continuing Adventures (UE)
YUGIOH DM8  AY8P|游戏王-毁灭的大邪神|Yu-Gi-Oh! - Reshef of Destruction (E)
BO_BOBO4_GBABOSJ|爆裂鼻毛真拳-热斗爆裂大战|Boboboubo Boubobo - Bakutou Hajike Taisen (J)
DRGBALLZBUKOAZJK|龙珠Z-舞空斗剧|Dragon Ball Z - Moogongtoogeuk (K)
BARBIE P&P  BAUE|芭比-公主与乞丐|Barbie - The Princess and the Pauper (U)
DBZBUUSFURY BG3E|龙珠Z-布欧的愤怒|Dragon Ball Z - Buu's Fury (U)
ZOIDS LEGACYAZ2E|机械兽新世纪|Zoids Legacy (U)
DISNEY HOTR BHMP|牧场是我家|Home on the Range (E)
POKEMON EMERBPEJ|口袋妖怪-祖母绿|Pocket Monsters - Emerald (J)
AV 7111     AGBJ|GBASP视频接收器|GBA AV Adapter (C)(Unl)
DRAGONBALL01MDBE|龙珠GT|Dragon Ball GT - Volume 1 (U)
JIMMYNEUAOTTBJYE|天才吉米|Adventures of Jimmy Neutron - Attack of the Twonkies (UE)
ADVANCE GH  BGCE|守护英雄|Advance Guardian Heroes (U)
MARIOGOLFGBABMGD|马里奥高尔夫巡回赛|Mario Golf - Advance Tour (G)
MARIOGOLFGBABMGI|马里奥高尔夫巡回赛|Mario Golf - Advance Tour (I)
MARIOGOLFGBABMGF|马里奥高尔夫巡回赛|Mario Golf - Advance Tour (F)
SPIDER-MAN 2BSPI|蜘蛛侠2|Spider-Man 2 (I)
STAR WARS TRBCKP|星球大战三部曲-学徒的原力|Star Wars Trilogy - Apprentice of the Force (E)
STAR WARS TRBCKE|星球大战三部曲-学徒的原力|Star Wars Trilogy - Apprentice of the Force (U)
MONSTER BASSA4BP|怪物巴斯钓鱼大赛|Monster! Bass Fishing (E)
F-ZERO2     BFZE|零式赛车-GP传说|F-Zero - GP Legend (U)
ADVANCE GH  BAGJ|守护英雄A|Advance Guardian Heroes (J)
EC2PICHIMO  BECJ|天使的收藏品2-成为杂志模特|Angel Collection 2 - Pichimo ni Narou (J)
DAN DOH!! TOBDNJ|高球小子-飞吧！胜利的微笑|Dan Doh!! Tobase Shouri no Smile Shot (J)
SYOGI       BSGJ|大家的将棋|Minna no Soft Series - Minna no Shogi (J)
HOT POTATO  AHPP|火热的马铃薯|Hot Potato! (E)
BBASKETBALL AYBE|后院篮球|Backyard Basketball (U)
ACTION MAN  BACP|武装战士罗伯·阿塔克|Action Man - Robot Atak (E)
AROUND THE WB8DP|80天环绕地球|Around the World in 80 Days (E)
BUBBLE BOBBLAONE|泡泡龙新加旧|Bubble Bobble - Old & New (U)
FAIRLYODDAGBBF2E|正义双亲:暗影决战|Fairly Odd Parents!, The - Shadow Showdown (U)
SHARK TALE  BSUE|鲨鱼故事|Shark Tale (UE)
BARBIE AS THBAUP|真假公主|Barbie - The Princess and the Pauper (E)
MSPAC-MANMM BPCE|吃豆先生：疯狂迷宫|Ms. Pac-Man - Maze Madness (U)
POKEMON FIREBPRS|口袋妖怪－火红|Pokemon - Edicion Rojo Fuego (S)
POKEMON LEAFBPGS|口袋妖怪－叶绿|Pokemon - Edicion Verde Hoja (S)
POKEMON LEAFBPGD|口袋妖怪－叶绿|Pokemon - Blattgruene Edition (G)
POKEMON FIREBPRD|口袋妖怪－火红|Pokemon - Feuerrote Edition (G)
POKEMON FIREBPRF|口袋妖怪－火红|Pokemon - Version Rouge Feu (F)
POKEMON LEAFBPGF|口袋妖怪－叶绿|Pokemon - Version Vert Feuille (F)
KILLSWITCH  BKHE|杀戮开关|Kill Switch (U)
NICKTOONS   BCCE|尼克卡通|Nicktoons - Freeze Frame Frenzy (U)
POKEGBAVID03MPCE|GBA电影－口袋妖怪卷3|Pokemon - Volume 3 (U)
POKEGBAVID04MPDE|GBA电影－口袋妖怪卷4|Pokemon - Volume 4 (U)
POKEMON FIREBPRI|口袋妖怪－火红|Pokemon - Versione Rosso Fuoco (I)
POKEMON LEAFBPGI|口袋妖怪－叶绿|Pokemon - Versione Verde Foglia (I)
NICKTOONS 02MN2E|GBA电影-尼克卡通收藏卷2|Nicktoons Collection - Volume 2 (U)
GBA_Capture tvap|电视接收器用软件V2.0(PAL制，需外设)|GBA TV Tuner PAL (C)(v2.0)(Unl)
GBA_Capture tvap|电视接收器用软件V1.3(PAL制，需外设)|GBA TV Tuner PAL (C)(Unl)
MARIOGOLFGBABMGS|玛里奥高尔夫|Mario Golf - Advance Tour (S)
POKEMON LEAFBPGE|口袋妖怪－叶绿|Pokemon - Leaf Green Version (E)
FIREEMBLEM8 BE8J|火焰的纹章－圣魔之光石|Fire Emblem - Seima no Kouseki (J)
THUG2       B2TE|托尼霍克－地下滑板2|Tony Hawk's Underground 2 (UE)
MARIO BALL  BMVE|玛里奥弹珠台|Mario Pinball Land (UA)
POKEMON FIREBPRE|口袋妖怪－火红|Pokemon - Fire Red Version (UE)
LEGO_KNIGHTSBKNE|乐高骑士王国|Knights' Kingdom (U)
STARSKYHUTCHAYHE|一路狂飚|Starsky & Hutch (U)
TITEUF THE CBTCF|黄毛狄多福|Titeuf Mega Compet (F)
AM 3D POOL  BPLE|立体台球|Archer Maclean's 3D Pool (U)
FIFA 2005   BF5E|FIFA足球2005|FIFA 2005 (UE)
SMPWAKEBOARDAWDE|水上滑板|Wakeboarding Unleashed featuring Shaun Murray (U)
MEGAMANZERO3BZ3E|洛克人3|Megaman Zero 3 (U)
MAWARUWARIO RZWJ|旋转瓦利奥|Mawaru - Made in Wario (J)
TAK&JUJUENG BT9E|塔克2:梦之杖|Tak 2 - The Staff of Dreams (U)
LILO&STITCH2BLSE|星际宝贝|Lilo & Stitch 2 - Haemsterviel Havoc (U)
SHARK TALE  BSUX|鲨鱼故事|Shark Tale (E)
LIZZIE 2    BL2E|平民天后2|Lizzie McGuire 2 - Lizzie Diaries (U)
THATSSORAVENBRVE|《That'sSoRaven》|That's So Raven (U)
TRON 2.0 KILBTNE|电子争霸战2.0之夺命应用|Tron 2.0 - Killer App (U)
TYBUSHRESCUEBTYE|古惑回力虎|Ty the Tasmanian Tiger 2 - Bush Rescue (UE)
CARTONETW002MC2E|卡通网收藏集|Cartoon Network Collection - Volume 2 (U)
WWTBAM      B55P|谁想成为百万富翁第2版|Who Wants to Be a Millionaire - 2nd Edition (E)
SDGFORCE    BGEE|SD高达力量|SD Gundam Force (U)
WWE_SURVIVORBWWE|世界摔角联盟系列|WWE - Survivor Series (UE)
AGB KIRBY AMB8KE|星之卡比-镜之迷宫|Kirby & the Amazing Mirror (U)
TMNT GBA 2  BT2E|忍者神龟2-并肩作战|Teenage Mutant Ninja Turtles 2 - Battle Nexus (U)
F-ZEROCLIMAXBFTJ|零式赛车-高潮|F-Zero - Climax (J)
BOKTAI2     U32E|我们的太阳2|Boktai 2 - Solar Boy Django (U)
ALLGROWNUPEYBALE|小淘气-我们长大了|All Grown Up - Express Yourself (UE)
LEGO_KNIGHTSBKNP|乐高骑士王国|Knights' Kingdom (E)
HOTWHEELS PABHZP|无敌风火轮赛车二合一|2 in 1 - Hot Wheels - Velocity X + Hot Wheels - World Race (E)
GOLDENNUGGETBGGE|淘金乐园|Golden Nugget Casino (U)
YAMADAHAJIMEBSYJ|战斗员山田一|Sentouin Yamada Hajime (J)
MONSTERTRUCKBMCE|怪兽大脚车|Monster Trucks (U)
F-18 HORNET BF8E|超级大黄蜂FA-18F攻击机|Super Hornet FA 18F (U)
HAMUTARO4   A84P|哈姆太郎-彩虹救援|Hamtaro - Rainbow Rescue (E)
GTA         BGTE|侠盗猎车A|Grand Theft Auto Advance (U)
YUGIOU DBT  BYDE|游戏王-命运之旅|Yu-Gi-Oh! - Destiny Board Traveler (U)
FRUITMURA   BFDJ|水果村的动物们|Fruit Mura no Doubutsutachi (J)
OSYARE PRI4 BOPJ|奥沙尔公主4/恋爱占卜大作战|Twin Series 2 - Oshare Princess 4 + Renai Uranai Daisakusen (J)
AKATHAN     BAZJ|小朋友的动物园|Aka-chan Doubutsuen (J)
OCHAKURU    BIKJ|小茶犬-温情谜语|Ochaken Kururin - Honwaka Puzzle de Hotto Shiyo (J)
SHREK 2.1   BSIE|史莱克2-穿长靴的猫|Shrek 2 - Beg for Mercy (UE)
DM SEMPAI   AA9P|卡片决斗高手-永恒的传说|Duel Masters - Sempai Legends (E)
KISEKAEANGELBE2J|换装天使|Majokko Cream-chan no Gokko Series 2 - Kisekae Angel (J)
WANKURU     BWKJ|宠物滚滚乐园|Wanko de Kururin! Wancle (J)
WANNYANIDOL BWAJ|汪仔偶像学园|Majokko Cream-chan no Gokko Series 1 - Wannyan Idol Gakuen (J)
PUKU22 CUPIDBPQJ|咕嘟咕嘟天然传阅板-爱神丘比特大作战|PukuPuku Tennen Kairanban - Koi no Cupid Daisakusen (J)
LICCA OSHAREBRNJ|莉卡的化妆日记|Licca-chan no Oshare Nikki (J)
KOINUISSYO2 BI2J|可爱小狗2|Koinu to Issho 2 (J)
GTA ADVANCE BGTP|侠盗猎车A|Grand Theft Auto Advance (E)
GBAZELDA MC BZMJ|塞尔达传说-缩小帽|Zelda no Densetsu - Fushigi no Boushi (J)
TEXAS HOLDEMBXAE|德克萨斯扑克牌|Texas Hold'em Poker (U)
NES ZELDA 2 FLBE|任天堂FC珍藏游戏系列第25辑|Classic NES Series - Zelda II - The Adventure of Link (UE)
CASTLEVANIA FADE|任天堂FC珍藏游戏系列第29辑|Classic NES Series - Castlevania (UE)
DR. MARIO   FDME|任天堂FC珍藏游戏系列第15辑|Classic NES Series - Dr. Mario (UE)
NES METROID FMRE|任天堂FC珍藏游戏系列第23辑|Classic NES Series - Metroid (UE)
INCREDBLEAGBBICE|超人特工队|Incredibles, The (UE)
ELF         BELE|圣诞精灵-电影版|Elf - The Movie (U)
THIRD AGE   B3AE|指环王-第三纪|Lord of the Rings, The - The Third Age (UE)
SHREK 2.1   BSIX|史莱克2-穿长靴的猫|Shrek 2 - Beg for Mercy (E)
DM KAIJUDO  BD6E|卡片决斗高手-最后的王牌|Duel Masters - Kaijudo Showdown (U)
POLAREXPRESSBPXE|极地快递|Polar Express, The (UE)
METAL SLUG  BSME|合金弹头A|Metal Slug Advance (U)
SMASHDRIVE  BSVE|疯狂驾驶员|Smashing Drive (U)
THE URBZ AGBBOCE|模拟人生-上流社会|Urbz, The - Sims in the City (UE)
GBAZELDA MC BZMP|塞尔达传说-缩小帽|Legend of Zelda, The - The Minish Cap (E)
FAIRLYODDAGBBF2D|反斗家族2-暗影决战|Cosmo & Wanda - Wenn Elfen helfen! - Das Schattenduell (G)
PFERDEHOFEURBPVP|马场生活|Pferd & Pony - Mein Pferdehof (E)
FINDINGNEMO2BZIY|海底总动员-冒险再续|Finding Nemo - The Continuing Adventures (E)
SHAMAN KING BSOE|通灵王-精神大师|Shaman King - Master of Spirits (U)
KIDSNEXTDOORBNDE|代号-邻家小孩|Codename Kids Next Door - Operation S.O.D.A. (U)
KINGDOMHEARTB8CJ|王国之心-记忆之链|Kingdom Hearts - Chain of Memories (J)
POKEMON RUBYAXVS|口袋妖怪-红宝石|Pokemon - Edicion Rubi (S)
POKEMON SAPPAXPS|口袋妖怪-蓝宝石|Pokemon - Edicion Zafiro (S)
SR MAHJONG DBDMJ|超级真实麻将同学会|Super Real Mahjong Dousoukai (J)
MESIA       BDLJ|真女神转生-恶魔少年|Shin Megami Tensei Devil Children - Messiah Riser (J)
LEMONY_ASOUEBLYE|雷蒙·斯尼奇的不幸历险|Lemony Snicket's A Series of Unfortunate Events (UE)
NICKTOONS   BCCX|尼克卡通-疯狂定格|SpongeBob SquarePants and Friends - Freeze Frame Frenzy (E)
INCREDBLEAGBBICX|超人特工队|Incredibles, The (E)
HOTWHEELSSTCBHEE|无敌风火轮赛车-障碍挑战赛|Hot Wheels - Stunt Track Challenge (UE)
CABELA'S BIGBG5E|坎贝拉猎鹿人2005|Cabela's Big Game Hunter - 2005 Adventures (UE)
WCPOKER     BP9E|世界扑克锦标赛|World Championship Poker (U)
NFSUG2      BNFE|极品飞车-地下狂飙2|Need for Speed Underground 2 (UE)
RAREDKC2    B2DE|大金刚2|Donkey Kong Country 2 (UA)
MARIOVSDK   BM5P|马里奥对大金刚|Mario vs. Donkey Kong (E)
KILLSWITCH  BKHP|战地杀机|Kill Switch (E)
DOTC        ADHP|王冠的守护者|Defender of the Crown (E)
TMNT GBA 2  BT2P|忍者神龟2-并肩作战|Teenage Mutant Ninja Turtles 2 - Battle Nexus (E)
BEYBLADEGREVBB2E|爆旋陀螺-G点旋转|Beyblade G-Revolution (U)
DRAGONBALLAABDVJ|龙珠大冒险|Dragon Ball - Advance Adventure (J)
YUYUHAKUSHO2BRGE|幽游白书-战略版|Yu Yu Hakusho - Ghostfiles - Tournament Tactics (UE)
AGB-P-BSMJ  BSMJ|合金弹头A|Metal Slug Advance (J)
CREATURESAGBACTY|造物计划|Creatures (E)
FEARFACTORULBFUE|谁敢来挑战|Fear Factor Unleashed (U)
GTA3MGP     BARP|游戏2合1-GP摩托/GTA赛车3|2 in 1 - Moto GP + GT Advance 3 - Pro Concept Racing (E)
FROGGER RPG BFJJ|青蛙冒险-古文明之谜|Frogger - Kodaibunmei no Nazo (J)
PAC-MANWORLDBPAE|小精灵世界|Pac-Man World (U)
NEMO&MONSGERBDZD|迪斯尼全集|2 in 1 - Die Monster AG + Findet Nemo (G)
STADIUMGAMESA9GE|田径运动会|Stadium Games (U)
TOMB RAIDER AL9E|古墓丽影-预言|Lara Croft Tomb Raider - The Prophecy (U)
INCREDBLEAGBBICD|超人特工队|Unglaublichen, Die (G)
GAKENALICE_1BASJ|学院爱丽丝-不可思议的心跳体验|Gakuen Alice - Dokidoki Fushigi Taiken (J)
FINDINGNEMO2BZIJ|海底总动员-新的冒险|Finding Nemo - Aratanaru Bouken (J)
TRON 2.0 KILBTNP|电子世界争霸战2.0|Tron 2.0 - Killer App (E)
DISNEY'S LILBLSP|星际宝贝2|Lilo & Stitch 2 (E)
BEYBLADEGREVBB2P|爆旋陀螺-G点旋转|Beyblade G-Revolution (E)
LEMONY_ASOUEBLYX|雷蒙·斯尼奇的不幸历险|Lemony Snicket's A Series of Unfortunate Events (E)
MARIO BALL  BMVP|马里奥弹珠台|Super Mario Ball (E)
SEEDDESTINY B42J|机动战士高达SEEDDestiny|Kidou Senshi Gundam Seed Destiny (J)
GBWARS1+2   BGWJ|高级战争1+2|Game Boy Wars Advance 1+2 (J)
RIVERA      BREJ|足球经理2004-05|Riviera - Yakusoku no Chi Riviera (J)
PREMIER MANABP4P|约束之地|Premier Manager 2004-2005 (E)
FF1&2DAWNOFSBFFE|最终幻想1+2:魂之黎明|Final Fantasy I & II - Dawn of Souls (UA)
INCREDBLEAGBBICI|超人特工队|Incredibili, Gli - Una 'Normale' Famiglia di Supereroi (I)
PAYBACK     BPKP|报复|Payback (E)
MSPAC-MANMM BPCP|小精灵大冒险|Ms. Pac-Man - Maze Madness (E)
MOERO JALECOBJCJ|燃烧系列集|Moero!! Jaleco Collection (J)
FF1&2DAWNOFSBFFP|最终幻想1+2:魂之黎明|Final Fantasy I & II - Dawn of Souls (E)
PAWAPOKE7   BP7J|实况口袋棒球7|Power Pro Kun Pocket 7 (J)
THE URBZ AGBBOCJ|模拟人生-上流社会|Urbz, The - Sims in the City (J)
SYLVANIA6   BSFJ|森林之家-成为流行设计家|Sylvanian Families - Fashion Designer ni Naritai! (J)
CINNAMON2-YDB2SJ|长耳狗-梦之大冒险|Cinnamon Game Series 2 - Yume no Daibouken (J)
LK_AND_DPGERBLPD|迪斯尼二合一|2 in 1 - Disneys Prinzessinnen + Koenig der Loewen, Der (G)
SBSPMOVIE   BSNX|超级海绵笨伯-电影版|SpongeBob SquarePants Movie, The (E)
DEADTORIGHTSBDEE|脱狱潜龙|Dead to Rights (U)
DORA SPR STRBDOE|小冒险家朵拉-超级巨星探险|Dora the Explorer - Super Star Adventures! (U)
MONOPOLY    BUME|垄断|Monopoly (U)
ITS MR PANTSBPIE|短裤先生|It's Mr. Pants (UE)
YOSHI'S U/G KYGJ|耀西的万有引力|Yoshi no Banyuuinryoku (J)
DEADTORIGHTSBDEP|脱狱潜龙|Dead to Rights (E)
PAC-MANWORLDBPAP|吃豆先生|Pac-Man World (E)
SB_SS_&_FTRFBDFP|超级海绵二合一|SpongeBob - Revenge of the Flying Dutchman + SuperSponge (E)
SPONGECOMP1MBSZX|超级海绵二合一|2 in 1 - SpongeBob - SuperSponge + Battle for Bikini Bottom (E)
RTYPE III   BR3P|神龙传III|R-Type III - The Third Lightning (E)
LK_AND_DPFREBLPF|迪斯尼二合一|2 in 1 - Disney Princesse + Roi Lion, Le (F)
KINGDOMHEARTB8CE|王国之心-记忆链条|Kingdom Hearts - Chain of Memories (U)
PURIYUMESONOBFPJ|梦之园大迷宫|Futari ha Precure - Arienaai! Yume no Sono ha Daimeikyuu (J)
CROKET!5    BK5J|陷饼!|Croket! Great - Toki no Boukensha (J)
PUKU23 BOARDB3PJ|咕嘟咕嘟幻想大陆|PukuPuku Tennen Kairanban - Youkoso! Illusion Land he (J)
ROCKEXE5_TOBBRBJ|洛克人EXE5蓝色团队|Rockman EXE 5 - Team of Blues (J)
ONMYOU ZERO BITJ|阴阳大战记-零式|Onmyou Taisenki Zeroshiki (J)
SPYRO ORANGEBS8J|宝贝龙|Spyro Advance - Wakuwaku Tomodachi Daisakusen! (J)
KRRCART_AGB BKJJ|青蛙军曹对决|Taiketsu! Gekisou Keronprix Daisakusen de Arimasu!! (J)
HELLO       BHDJ|忘却的旋律|Hello! Idol Debut - Kids Idol Ikusei Game (J)
CRASH PURPLEBKDJ|蛊惑狼A友情大作战|Crash Bandicoot Advance - Wakuwaku Tomodachi Daisakusen! (J)
BOUKYAKU    BBSJ|忘却的旋律|Boukyaku no Senritsu (J)
PR_TF&NS_GERBRZD|恐龙战队合集|2 in 1 - Power Rangers - Ninja Storm + Time Force (G)
AGB-BSMP    BSMP|合金弹头A|Metal Slug Advance (E)
MONOPOLY    BUMP|大富翁|Monopoly (E)
DUELMASTERS3BDUJ|决斗大师3|Duel Masters 3 (J)
CAKECASTLE  BLIJ|小西点之蛋糕城|Little Patissier - Cake no Oshiro (J)
SHINMEDA-KBTBKVJ|真型徽章机器人-甲虫版|Shingata Medarot - Kabuto Version (J)
SHINMEDA-KWGBKUJ|真型徽章机器人-锹甲版|Shingata Medarot - Kuwagata Version (J)
MIRUMODEPON5BWPJ|任性妖精米尔莫|Wagamama Fairy - Nazo no Kagi to Shinjitsu no Tobira (J)
DANGEROUS-G3BJ3J|绝体绝命顽固老头3|Zettaizetsumei Dangerous Jiisan 3 - Hateshinaki Mamonogatari (J)
JUSTIRISER  BGJJ|地球的战士们|Genseishin Justirisers Souchaku Chikyuu no Senshitachi (J)
GASH-ZAKERU2BGYJ|金色卡修！友情电击2|Konjiki no Gashbell!! - Unare! Yuujou no Zakeru 2 (J)
THIRD AGE   B3AJ|指环王-中之国第三纪|Lord of the Rings, The - Nakatsukuni Daisanki (J)
VRALLY 3    AVRE|v拉力3|V-Rally 3 (U)
GARFIELDTSFPBGOP|加菲猫-寻找波姬|Garfield - The Search for Pooky (E)
RACING GEARSBRAP|改装赛车A|Racing Gears Advance (E)
EXTREME GHOSAEGE|终极魔鬼克星|Extreme Ghostbusters - Code Ecto-1 (U)
TOWNARIKIRI3B3TJ|世界传说-换装迷宫|Tales of the World - Narikiri Dungeon 3 (J)
JAMES POND 2AJDP|詹姆斯庞得-代号Robocod|James Pond - Codename Robocod (E)
YUGIOHDMI2  BYIJ|游戏王世界卡牌决斗2|Yu-Gi-Oh! Duel Monsters - International Worldwide Edition 2 (J)
KISSKISS    B2KJ|星铃学园|Kiss x Kiss Seirei Gakuen (J)
MEDABOTSRKSVA9BE|徽章机器人-绿书版|Medabots - Rokusho Version (U)
WTATOUR     ATEE|WTA女子网球巡回赛|WTA Tour Tennis (U)
AMERICANTAILAFGE|美国鼠谭-淘金记|An American Tail - Fievel's Gold Rush (U)
LANDBEFORETIALAE|小脚板走天涯收藏版|Land Before Time, The (U)
STRAWBERRYSCB35E|草莓酥饼的夏季A|Strawberry Shortcake - Summertime Adventure (U)
BANJO PILOT BAJE|班卓飞行员|Banjo Pilot (U)
GBAZELDA MC BZME|塞尔达传说缩小帽|Legend of Zelda, The - The Minish Cap (U)
MARIOPARTYJAB8MJ|马里奥聚会A|Mario Party Advance (J)
LK_&_BB_MULTBLBX|迪斯尼2合1)|2 in 1 - Brother Bear + The Lion King (E)
VATTROLLERX1BRXJ|球斗士X|Vattroller X (J)
HOBBIT NO BOAH9J|冒险王比特狩魔之旅|Hobbit no Bouken - Lord of the Rings - Hajimari no Monogatari(J)
VANDELBUSTERBOVJ|指环王前传霍比特人的冒险|Bouken Ou Beet - Busters Road (J)
LEMONY_ASOUEBLYD|雷蒙斯尼奇的不幸历险|Lemony Snicket - Raetselhafte Ereignisse (G)
ALADDIN     BADE|迪斯尼-阿拉丁|Aladdin (U)
JINGUJISHIROBT3J|侦探神宫寺三郎白影少女|Tantei Jinguuji Saburou - Shiroi Kage no Shoujo (J)
KOUMEIDEN   B3QJ|超级躲避球|Sangokushi - Koumeiden (J)
EIKETSUDEN  B3EJ|三国志英杰传|Sangokushi - Eiketsuden (J)
DODGEBALL   BG8J|三国志孔明传|Ganbare Dodge Fighters (J)
SEGA ARCADE AYPE|世嘉经典街机回顾|Sega Arcade Gallery (U)
SPACE CHANNEA5UP|太空频道5-舞啦啦之炫耀攻击|Space Channel 5 - Ulala's Cosmic Attack (E)
SRWOG2      B2RJ|超级机器人大战-原创世纪2|Super Robot Taisen - Original Generation 2 (J)
KINGOFSWINGEBBKP|大金刚-摇摆王|DK - King of Swing (E)
GREMLINS STRAGGE|魔怪小精灵|Gremlins - Stripe vs Gizmo (U)
REIGN OF FIRAR9P|火焰统治|Reign of Fire (E)
ROCKY       AROP|洛奇拳击|Rocky (E)
ROCK_EXE4_RSB4WP|洛克人网络战斗4-红太阳|Megaman Battle Network 4 Red Sun (E)
SK LOS HAWK BHLE|通灵王-精神遗产之翱翔之鹰|Shaman King - Legacy of the Spirits - Soaring Hawk (U)
SK LOS WOLF BWSE|通灵王-精神遗产之疾速之狼|Shaman King - Legacy of the Spirits - Sprinting Wolf (U)
WINNIE THE PBWHE|小熊维尼-崎岖的冒险历程|Winnie the Pooh's Rumbly Tumbly Adventure (U)
IK PLUS     A3KE|国际空手道大赛-加强版|International Karate Plus (U)
HYDRA       AFHE|决战九头蛇|Strike Force Hydra (U)
SPR DROPZONEAZNE|超级月面地带|Archer Maclean's Super Dropzone (U)
WORLD TENNISAWCE|世界网球明星|World Tennis Stars (U)
MEDABOTSMTBVA8BE|徽章战士-马达比版|Medabots - Metabee Version (U)
POLLY POCKETAOTE|波利口袋|Polly Pocket! - Super Splash Island (U)
ROCK_EXE4_BMB4BP|洛克人网络战斗4-蓝月亮|Megaman Battle Network 4 Blue Moon (E)
X-BLADEZ    AXIE|X旋风直排轮溜冰|X-Bladez - Inline Skater (U)
ROBOT WARS AARUE|遥控机器人大战之无尽的毁灭|Robot Wars - Advanced Destruction (U)
ADVANCE GH  BGCP|守护英雄A|Advance Guardian Heroes (E)
YWCT2005USA BY7E|游戏王-世界锦标赛2005|Yu-Gi-Oh! - 7 Trials to Glory - WCT 2005 (U)
BANJO PILOT BAJP|班卓飞行员|Banjo Pilot (E)
ASTRO BOY-OMBTAP|铁臂阿童木-阿童木心之秘密|Astro Boy - Omega Factor (E)
POWER RANGERBPOX|鸟人战队-巨龙雷鸣|Power Rangers - Dino Thunder (E)
LEGENDZSON__BLVJ|苏生龙王传说|Legendz - Sign of Nekuromu (J)
DRSEUSSCITHTBCTE|爱戴帽子的猫博士|Cat in the Hat by Dr. Seuss, The (U)
BANJOKAZOOIEBKZS|琴音笛声-格兰蒂的复仇|Banjo-Kazooie - La Venganza de Grunty (S)
ZOIDSFUZORS BZFJ|机兽新世纪|Zoids Saga Fuzors (J)
INCREDBLEAGBBICS|超人特工队|Increibles, Los (S)
FINDINGNEMO2BZIX|海底总动员-冒险再续|Finding Nemo - The Continuing Adventures (E)
ASOT        A3QE|雷霆之音|Sound of Thunder, A (U)
ACE COMBAT  BAEE|王牌空战A|Ace Combat Advance (UE)
KLONOA2     AN6E|风之克罗帝亚2|Klonoa 2 - Dream Champ Tournament (U)
ARMY WAR    BG6E|超级战争|Super Army War (U)
ROBOTS      BRTE|机器人|Robots (U)
PLAYAN      ZMAJ|任天堂Playan电影播放器|Play-Yan (J)
ROCKEXE5_TOCBRKJ|洛克人EXE5-卡奈尔之队|Rockman EXE 5 - Team of Colonel (J)
KONG        AKQE|金刚之旅|Kong - The Animated Series (U)
DIGIMON BATTBDSP|数码宝贝精神大作战2|Digimon - Battle Spirit 2 (E)
POKEMON RUBYAXVI|口袋妖怪-红宝石v1.1|Pokemon - Versione Rubino (I)
POKEMON SAPPAXPI|口袋妖怪-蓝宝石v1.1|Pokemon - Versione Zaffiro (I)
SILENT SCOPEAIPP|沉默的狙击手|Silent Scope (E)
RACING GEARSBRAE|高速赛车|Racing Gears Advance (U)
SHARK STORY BSUI|鲨鱼故事|Shark Story (I)
AEROACROBATXAAOP|蝙蝠侠|Aero the Acro-Bat - Rascal Rival Revenge (E)
YUYUHAKUSHO1BYYP|幽游白书-灵界侦探|Yu Yu Hakusho - Ghostfiles - Spirit Detective (E)
SALT LAKE 20AWGP|盐湖城冬季奥运会2002|Salt Lake 2002 (E)
WINNIE THE PBWHP|小熊维尼-崎岖的冒险历程|Winnie the Pooh's Rumbly Tumbly Adventure (E)
ROBOTS      BRTP|机器人|Robots (E)
BLADESOFTHDRBBHE|雷霆之刃|Blades of Thunder (U)
TOPGUN CZ   A2YE|壮志凌云-战区|Top Gun - Combat Zones (U)
RAVE MASTER BRME|圣石小子-特殊武力|Rave Master - Special Attack Force! (U)
MEZA_KOUSIENBMKJ|目标！甲子园|Mezase Koushien (J)
CONTRAADVANCAAWP|魂斗罗-异型战争EX|Contra Advance - The Alien Wars EX (E)
GLORY DAYS  BG6P|超级战争|Glory Days (E)
SENNENKAZOKUBKAJ|千年家族|Sennen Kazoku (J)
HOODLUMS REVBRYP|雷曼-阿飞复仇|Rayman - Hoodlums' Revenge (E)
SBREVENGEGBABDFE|游戏2合1-超级海绵笨伯|SpongeBob Revenge of the Flying Dutchman + SuperSponge (U)
SD_CC&MH_EFGBCVE|游戏2合1-史诺比鬼屋历险|Scooby-Doo! - Mystery Mayhem + Cyber Chase (U)
KAPPA       BK8J|河童大冒险|Kappa no Kai-Kata Katan Daibouken (J)
MARIOGOLFGBABMGP|马里奥高尔夫|Mario Golf - Advance Tour (E)
DISNEY PRINCAQDS|迪士尼公主|Disney Princesas (S)
LIZ_PRIN_SPABLDS|游戏2合1-迪斯尼公主/平民天后|2 in 1 - Disney Princesas + Lizzie McGuire (S)
DM KAIJUDO  BD6P|卡片决斗高手|Duel Masters - Kaijudo Showdown (E)
NEMO_MON_SPABDZS|游戏2合1-迪斯尼游戏集|2 in 1 - Monstruos, S.A. + Buscando a Nemo (S)
BASEBALL2006BCYE|后院棒球2006|Backyard Baseball 2006 (U)
HOODLUMS REVBRYE|雷曼-阿飞复仇|Rayman - Hoodlum's Revenge (U)
BIONICLE_MOSBILP|乐高荒岛冒险-幽影迷宫|Bionicle - Maze of Shadows (E)
TAK&JUJUMULTBT9X|塔克2-梦想之杖|Tak 2 - The Staff of Dreams (E)
MAYA THE BEEBEEP|小蜜蜂玛雅-甜美的黄金|Maya the Bee - Sweet Gold (E)
PUYO POP FEVBPFP|魔法气泡大会战-狂热版|Puyo Pop Fever (E)
CASTLECAPERSARGS|小淘气-城堡冒险|Rugrats - Travesuras en el Castillo (S)
SANGOKUMUSOUB36J|真·三国无双|Shin Sangoku Musou Advance (J)
NYANNYANKO01BNYJ|咪咪小猫收藏集|Nyan Nyan Nyanko no Nyan Collection (J)
MARIOPARTYUSB8ME|马里奥聚会|Mario Party Advance (U)
LEGOSTARWARSBLWE|乐高星球大战|LEGO Star Wars - The Video Game (UE)
SHARK TALE  B9TJ|鲨鱼故事|Shark Tale (J)
LIZ_PRIN_ENGBLDP|迪斯尼公主/平民天后|2 in 1 - Disney Princess + Lizzie McGuire (E)
NEMO_MON_ITABDZI|迪斯尼游戏2合1|2 in 1 - Monsters & Co. + Alla ricerca di Nemo (I)
KILLER3DPOOLB3LP|3维撞球杀手|Killer 3D Pool (E)
MR. DRILLER2BR2E|钻地小子2|Mr. Driller 2 (U)
YWCT2005EUR BYOP|游戏王-世界冠军赛2005|Yu-Gi-Oh! - Day of the Duelist - WCT 2005 (E)
ONEPIEBASEBABO8K|海贼王-棒球进行曲|One Piece - Going Baseball - Haejeok Yaku (K)
DRAGONBALLAABDVK|龙珠大冒险|Dragon Ball - Advance Adventure (K)
EVILMIRROR  AHJE|雨果-邪恶的镜子|Hugo - The Evil Mirror Advance (U)
TXRA        BTZE|东京极限竞速|Tokyo Xtreme Racer Advance (U)
SPONGEBOB003MS3E|电影-超级海绵第3卷|SpongeBob SquarePants - Volume 3 (U)
CARTONETW006MCNE|电影-卡通频道珍藏电影白金版|Cartoon Network Collection - Platinum Edition (U)
DISNEYVOL001MDCE|电影-迪斯尼频道珍藏系列第1卷|Disney Channel Collection - Volume 1 (U)
YOSHI'S U/G KYGP|耀西的万有引力|Yoshi's Universal Gravitation (E)
SUPERROBOT01MSRE|电影-超级机械猴队第1卷|Super Robot Monkey Team - Volume 1 (U)
SMASHDRIVE  BSVP|疯狂驾驶员|Smashing Drive (E)
POPEYE RFS  APOE|大力水手-冲向菠菜|Popeye - Rush for Spinach (U)
ROCKMANZERO4B4ZJ|洛克人Zero4|Rockman Zero 4 (J)
BROTHER BEARBBRP|迪斯尼小熊的兄弟们|Brother Bear (E)
GOEMON1&2   BG2J|加油伍佑卫门1+2|Kessakusen! Ganbare Goemon 1+2 (J)
DETECTIVE C2BQAJ|名侦探柯南黎明之碑|Meitantei Conan - Akatsuki no Monument (J)
PAC PINBALL BP8E|吃豆弹珠台|Pac-Man Pinball Advance (U)
OCHAKENDREAMBCUJ|茶犬的梦想|Ochaken no Yumebouken (J)
DRAGONDREAM BIPJ|海贼王-龙之梦|One Piece - Dragon Dream (J)
THE TOWER   BTRJ|模拟大厦SP|Tower SP, The (J)
POKEMON SAPPAXPF|口袋妖怪蓝宝石|Pokemon - Version Saphir (F)
POKEMON RUBYAXVF|口袋妖怪红宝石|Pokemon - Version Rubis (F)
ESPN XG SNOWAWXP|ESPN冬季运动会-滑雪板2002|ESPN Winter X-Games Snowboarding 2 (E)
HAPPYTRUMP20BTLJ|大众软件系列-快乐法宝20|Minna no Soft Series - Happy Trump 20 (J)
MR INCREDIBLBICJ|超人特工队|Mr. Incredible (J)
POKEMON RUBYAXVD|口袋妖怪红宝石|Pokemon - Rubin-Edition (G)
POKEMON SAPPAXPD|口袋妖怪蓝宝石|Pokemon - Saphir-Edition (G)
POKEMON EMERBPEE|口袋妖怪绿宝石|Pokemon - Emerald Version (UE)
KILLER3DPOOLB3LE|3维撞球杀手|Killer 3D Pool (U)
PROUDFAMIL01MFPE|TheProudFamilyVolume1|Proud Family, The - Volume 1 (U)
KINGDOMHEARTB8CP|王国之心-记忆之链|Kingdom Hearts - Chain of Memories (E)
RILAKKUMADAYBR9J|利乐熊的每一天|Relaxuma na Mainichi (J)
BATTLEMASTERBQBJ|昆虫怪兽-战斗大师|Konchuu Monster Battle Master (J)
B STADIUM   BQSJ|昆虫怪兽-战斗竞技场|Konchuu Monster Battle Stadium (J)
STAR WARS   BE3P|星球大战前传III-西斯的复仇|Star Wars Episode III - Revenge of the Sith (E)
SCRABLEBLASTBLAE|拼字游戏|Scrabble Blast! (U)
CARTONETW005MCME|GBA电影-卡通频道珍藏电影-限定版|Cartoon Network Collection - Limited Edition (U)
WWTBAM      A55U|谁想成为百万富翁|Who Wants to Be a Millionaire (A)
FIREEMBLEM2EBE8E|火炎之纹章-圣魔之光石|Fire Emblem - The Sacred Stones (UA)
STARWARSROTSBE3E|星球大战前传III-西斯的复仇|Star Wars Episode III - Revenge of the Sith (U)
MONT_NEMO   BDZP|游戏2合1-迪斯尼游戏集|2 in 1 - Monsters, Inc. + Finding Nemo (E)
WARIOTWISTEDRZWE|旋转瓦里奥|WarioWare - Twisted! (U)
PET GALLERY2BKPJ|可爱宠物系列-游戏集锦2|Kawaii Pet Game Gallery 2 (J)
DOGWONDERFULB82J|可爱小狗|Kawaii Koinu Wonderful (J)
WANKOMIKKUSUBWXJ|小狗米克斯-爱情世界|Wanko Mix Chiwanko World (J)
MADAGASCAR  BGZE|马达加斯加|Madagascar (U)
METALMAX2KAIA9TJ|重装机兵2·改|Metal Max 2 Kai (J)
POKEMON RUBYAXVE|口袋妖怪红宝石|Pokemon - Ruby Version (E)
LEGOKK&BB_EGBL5P|2合1-乐高游戏集锦|2 in 1 - Bionicle + Knights' Kingdom (E)
BURABURADNKYBBKJ|大金刚-摇摆王|Bura Bura Donkey (J)
BB_&_DP_GER_BWBD|2合1-熊兄弟+迪斯尼公主|2 in 1 - Disneys Prinzessinnen + Baerenbrueder (G)
SD_CC&MH_EFGBCVP|2合1-史诺比鬼屋历险|Scooby-Doo! - Mystery Mayhem + Cyber Chase (E)
POKEMON SAPPAXPE|口袋妖怪-蓝宝石|Pokemon - Sapphire Version (UE)
BB_&_DP_SPANBWBS|2合1-熊兄弟+迪斯尼公主|2 in 1 - Disney Princesas + Hermano Oso (S)
BOKTAI2     U32P|我们的太阳2|Boktai 2 - Solar Boy Django (E)
MARIOPARTYEUB8MP|马里奥聚会|Mario Party Advance (E)
MEGAMAN5_TC_BRKP|洛克人网络战斗5：卡奈尔之队|Megaman Battle Network 5 Team Colonel (E)
MEGAMAN5_TP_BRBP|洛克人网络战斗5：普洛特曼之队|Megaman Battle Network 5 Team Protoman (E)
MUPPET PINBAAMWP|芝麻街弹珠台|Muppet Pinball Mayhem (E)
SHREK REEKINAOIP|史瑞克-恶臭大灾难|Shrek - Reekin' Havoc (E)
LEMONY_ASOUEBLYI|雷蒙·斯尼奇的不幸历险|Lemony Snicket - Una Serie di Sfortunati Eventi (I)
WINGS       AWQP|翼|Wings (E)
BATMANBEGINSBBGE|蝙蝠侠诞生|Batman Begins (UE)
YOSHI TOPSY KYGE|耀西的万有引力|Yoshi - Topsy-Turvy (U)
DRAGONBALLAABDVP|龙珠大冒险|Dragon Ball - Advanced Adventure (E)
NEGIMAGI    BNGJ|魔法先生|Mahou Sensei Negima! - Private Lesson Damedesuu Toshokanjima (J)
FROG: TEMPLEAFRP|青蛙冒险-蛙之殿堂|Frogger's Adventures - Temple of the Frog (E)
SIKAMARUKOSAB4RJ|方脑壳脑力修行:国语/算术/理科/社会|Shikakui Atama wo Marukusuru - Kokugo Sansu Rika Shakai (J)
PLUSTER RPG2BPDJ|冒险游记-未发现的传说EX|Bouken Yuuki Pluster World - Densetsu no Plust Gate EX (J)
SIKAMARUKAKEB4KJ|方脑壳脑力修行：汉字、计算|Shikakui Atama wo Marukusuru Advance - Kanji Keisan (J)
PRTF        APRF|鸟人战队合集-时间力量|Power Rangers - La Force du Temps (F)
COMPILATION2B2AP|游戏2合1-美丽新世界+幻想新国度|Asterix & Obelix - Bash Them All! + Asterix & Obelix XXL (E)
HERBIE FL   B8FE|迪斯尼疯狂赛车|Herbie - Fully Loaded (U)
MEGAMAN5_TC_BRKE|洛克人网络战斗5：卡奈尔之队|Megaman Battle Network 5 Team Colonel (U)
MUSHIKING GCBK6J|甲虫王国-格莱特斯特冠军之路|Kouchu Ouja Mushiking (J)
CHAILIEN NO BKRJ|团团转难题大集合|No no no Puzzle Chailien (J)
MEGAMAN5_TP_BRBE|洛克人网络战斗5：普洛特曼之队|Megaman Battle Network 5 Team Protoman (U)
M&D MAGICAL3BMQE|迪斯尼米老鼠和唐老鸭3|Magical Quest 3 Starring Mickey & Donald (U)
MADAGASCAR  BGZX|马达加斯加|Madagascar (E)
FANTASTIC4  BF4E|神奇四侠|Fantastic 4 (U)
RIVIERA     BREE|约束之地|Riviera - The Promised Land (U)
FANTCHILDRENBFCJ|奇幻儿童|Fantastic Children (J)
COMPILATION1BCSP|游戏2合1-V拉力3+特技人|2 in 1 - V-Rally 3 + Stuntman (E)
LK_AND_DP_SPBLPS|游戏2合1-女孩装|2 in 1 - Disney Princesas + Rey Leon, El (S)(Spa+M8)
WARIOWAREINCAZWC|瓦里奥制造|Waliou Zhizao (C)
ZEROMISSIONCBMXC|密特罗德-零点任务|Miteluode - Lingdian Renwu (C)
MOMOTETSU-G BM2J|桃太郎电铁G|Momotarou Dentetsu G Gold Deck wo Tsukure! (J)
CASINO/HOLDMBWCE|游戏2合1-棋牌2合1|2 in 1 - Golden Nugget Casino + Texas Hold'em Poker (U)
EREMENTAR G BEJJ|武器种族传说-封印之诗歌|Erementar Gerad (J)
MARHEAVEN1  BM9J|敲击天堂之门|MAR - Knockin' on Heaven's Door (J)
OSYARE PRI5 BO5J|奥沙尔公主5|Oshare Princess 5 (J)
FANTASTIC4  BF4X|神奇四侠|Fantastic 4 (E)
HERBIE FL   B8FP|迪斯尼疯狂金车|Herbie - Fully Loaded (E)
LEGOSTARWARSBLWJ|乐高星球大战|LEGO Star Wars - The Video Game (J)
SUPERPAKVOL1B5AP|游戏2合1-古惑狼+小龙斯派罗-第1卷|Crash & Spyro - Season of Ice + N-Tranced (E)
SUPERPAKVOL2B52P|游戏2合1-古惑狼+小龙斯派罗-第2卷|Spyro 2 - Season of Flame + Crash Nitro Kart (E)
DYN WARS ADVB36E|真·三国无双A|Dynasty Warriors Advance (UA)
KINGOFSWING BBKE|大金刚-摇摆王|DK - King of Swing (UA)
SBSS_&RGW_ENBRSP|游戏2合1-超级海绵+小淘气|Rugrats - Go Wild + SpongeBob SquarePants - SuperSponge (E)
TOWERSHAFT  BABJ|阿莱克博顿大冒险-塔与桥的大冒险|Aleck Bordon Adventure - Tower & Shaft Advance (J)
CHARLIE AND BCFE|查理与巧克力工厂|Charlie and the Chocolate Factory (U)
BLEACH ADV1 BLEJ|死神|Bleach Advance - Kurenai ni Somaru Soul Society (J)
KIMPOSSIBLE BKMJ|迪斯尼之麻辣女孩|Kim Possible (J)
LILO&STITCH BLSJ|星际宝贝|Lilo & Stitch (J)
HARONOPUYOPUBH6J|哈罗之咕噜咕噜砖块|Kidou Gekidan Haro Ichiza Haro no Puyo Puyo (J)
CHARLIE AND BCFP|查理和巧克力工厂|Charlie and the Chocolate Factory (E)
PINBALL OF TAPDP|死亡弹珠台|Pinball of the Dead, The (E)
HM MFOM USA BFGE|牧场物语-矿石镇上的更多朋友们|Harvest Moon - More Friends of Mineral Town (U)
PURIMAJIMAJIBFMJ|美丽祭师二人组MaxHeart|Futari ha Precure Max Heart - Maji Maji! Fight de IN Janai (J)
GASH-CARDGBABKEJ|金色卡修GBA卡片大乱斗|Konjiki no Gashbell!! The Card Battle for GBA (J)
BOKTAI3     U33J|新·我们的太阳逆袭的撒巴塔|Shin Bokura no Taiyou - Gyakushuu no Sabata (J)
KIMPOSSIBLE3BQPE|迪士尼麻辣女孩3|Kim Possible III - Team Possible (U)
TWIN SERIES4BHFJ|双子系列4:哈姆哈姆妖怪+哈姆太郎F猜谜|Hamu Hamu Monster EX + Fantasy Puzzle Hamster Monogatari (J)
TWIN SERIES5BMWJ|双子系列5:汪汪名侦探+魔法王国蛋糕屋|Wanwan Meitantei EX + Mahou no Kuni no Cake-yasan Monogatari (J)
TWIN SERIES6BWNJ|双子系列6:汪仔偶像学园+可爱小狗|Twin Series 6 - Wannyan Idol Gakuen + Koinu to Issho Special (J)
RAVEN2      BZSE|迪士尼就如此瑞文2-神奇风格|That's So Raven 2 - Supernatural Style (U)
SHAMAN KING2B2ME|通灵王-灵魂大师2|Shaman King - Master of Spirits 2 (U)
ZOOO        BMZP|动物饲养员|Zooo (E)
PRNS&TFFRE  BRZF|恐龙战队合集|Power Rangers - Ninja Storm + La Force du Temps (F)
MADDEN 2006 B6ME|美国橄榄球联盟2006|Madden NFL 06 (U)
DBGTTRANSFORBT4E|龙珠GT|Dragon Ball GT - Transformation (U)
STEEL EMPIREBKTP|钢铁帝国|Steel Empire (E)
GUMBY       BGVE|格宾Vs阿斯特罗伯特|Gumby vs. the Astrobots (U)
SBSP_&_JNBG_BBJP|超级海绵大冒险+吉米奴顿|SpongeBob - Bikini Bottom + Jimmy Neutron - Boy Genius (E)
SHREK SHARK BS7P|2合1鲨鱼帮+史瑞克2|2 in 1 - Shrek 2 + Shark Tale (E)
MADAGASCAR  BGZP|马达加斯加|Madagascar (E)
ANIMANIACS: ANIP|卡通城灯光,相机,开始|Animaniacs - Lights, Camera, Action! (E)
PREMIER MANABP5P|英超足球经理2005-2006|Premier Manager 2005-2006 (E)
TWIN SERIES3BQMJ|双子系列3昆虫怪兽决斗+超级中国迷宫|Twin Series 3 - Konchuu Monster + Suchai Labyrinth (J)
TWIN SERIES7B2PJ|双子系列7宠物换装Ex+彩虹魔法拼图|Twin Puzzle - Kisekae Wanko Ex + Puzzle Rainbow Magic 2 (J)
SPY HUNTER  AHNP|间谍猎人|SpyHunter (E)
SIGMA STAR  B3GE|西格马星际传奇|Sigma Star Saga (UE)
LIZMCGUIRE3 BL3E|莉琪的异想世界3|Lizzie McGuire 3 - Homecoming Havoc (U)
TUWAMONOGBA B2OJ|职业麻将|Pro Mahjong Tsuwamono GBA (J)
PAC WORLD 2 B2CP|吃豆人世界2|Pac-Man World 2 (E)
MKALLIANCE  AXDP|真人快打-致命联盟|Mortal Kombat - Deadly Alliance (E)
RISKCOMP    B66E|风险,战舰,线索|Risk, Battleship, Clue (U)
BOARDGAMES  B6EE|桌上游戏经典之作|Board Game Classics (U)
ED EDD EDDY AE3P|艾艾德艾迪三个好朋友|Ed, Edd n Eddy - Jawbreakers! (E)
DEXTER CHESSADXP|德克斯特的实验室-疯狂西洋棋挑战|Dexter's Laboratory - Chess Challenge (E)
SPIDER-MAN MBX3P|蜘蛛侠2合1|2 in 1 - Spider-Man + Spider-Man 2 (E)
THUG SLATER BX4E|地下滑板+职业冲浪板|Tony Hawk's Underground + Kelly Slater's Pro Surfer (UE)
PAC PINBALL BP8P|吃豆弹珠台A|Pac-Man Pinball Advance (E)
PINBALL TYCNA2TP|弹珠台大亨|Pinball Tycoon (E)
KUNIKORE01  B9AJ|国夫之热血纪念馆1|Kunio Kun Nekketsu Collection 1 (J)
SPIDEYMM X2 BX2E|2合一蜘蛛人与X-men金刚狼|Spider-Man - Mysterio's Menace + X2 - Wolverine's Revenge (UE)
MADAGASCAR  BGZS|马达加斯加|Madagascar (S)
MONSTER JAM AJAP|怪物卡车大毁灭|Monster Jam - Maximum Destruction (E)
AMDRIVERBTLPBGPJ|AM驾驶员-出击！战斗聚会|Get Ride! Amdriver Shuggeki! Battle Party (J)
POKEINU     BTDJ|口袋小狗|Poke Inu (J)
ROCK_EXE4_RSB4WJ|洛克人EXE4红太阳v1.1|Rockman EXE 4 - Tournament Red Sun (J)
CONNECT4COMPB65E|小游戏3合一|Connect Four, Perfection, Trouble (U)
KLAXCOMP    B68E|滚动球&旋转方块|Marble Madness, Klax (U)
CENTIPEDECOMB6ZE|小游戏3合一|Breakout, Centipede, Warlords (U)
NAMCO 50    B5NE|南梦宫博物馆50周年|Namco Museum - 50th Anniversary (U)
PAPERBOYCOMPB6BE|小游戏2合一|Paperboy, Rampage (U)
PONGCOMP    B64E|小游戏3合一|Pong, Asteroids, Yars' Revenge (U)
SCRABBLECOMPB67E|小游戏3合一|Sorry!, Aggravation, Scrabble Junior (U)
CASPER      ACSE|卡斯帕|Casper (U)
REBELSTAR   BRLE|叛星-战略指挥官|Rebelstar - Tactical Command (U)
NIGHTMARE   BNCJ|圣诞惊魂夜|The Nightmare Before Christmas - The Pumpkin King (J)
MIRUMODEPON6BMIJ|任性妖精Milmo永久纪念|Wagamama Fairy Mirumo de Pon! - Dokidoki Memorial Panic (J)
RAYMAN 10TH BX5P|雷曼10周年包|Rayman 10th Anniversary - Rayman Advance + Rayman 3 (E)
BOARDGAMES  B6EP|经典桌面游戏|Board Game Classics (E)
JAMES POND 2AJDE|詹姆斯庞得-代号Robocod|James Pond - Codename Robocod (U)
FANTASTIC4  BF4P|神奇四侠|Fantastic 4 (E)
SRWJ        B6JJ|超级机器人大战J|Super Robot Taisen J (J)
MARIOTENNISABTMJ|马力欧网球A|Mario Tennis Advance (J)
DRMARIO&PONJBZPJ|马力欧医生&魔法宝石|Dr. Mario & Panel de Pon (J)
KOALA_BROS  BAKP|熊兄弟|Koala Brothers - Outback Adventures (E)
MEGAMANZERO4B4ZP|洛克人ZERO4|Megaman Zero 4 (E)
YUGIOU DBT-EBYDP|游戏王!命运之旅|Yu-Gi-Oh! - Destiny Board Traveler (E)
SHAMAN KING BSOP|通灵王-精神大师|Shaman King - Master of Spirits (E)
BARBIEPEGASUBE5E|芭比和魔法天马|Barbie and the Magic of Pegasus (U)
SD_MP_&MU_SPBPUS|二合一:史努比系列|2 in 1 - Scooby-Doo + Scooby-Doo 2 - Desatado (S)
PRPACKNJS&TFBRZP|二合一:恐龙战队系列|Power Rangers - Ninja Storm + Power Rangers - Time Force (E)
SCOOBYMOVIEEAP8P|史努比|Scooby-Doo (E)
GYAKUTEN_SAIASBJ|逆转裁判|Gyakuten Saiban (J)
CNDOUBLEGAMEBW2E|二合一:卡通网络系列|Cartoon Network Block Party + Cartoon Network Speedway (U)
TRUCKS/FURY BWQE|二合一:大脚赛车+沙漠狂暴人竞技赛|2 in 1 - Quad Desert Fury + Monster Trucks (U)
PRNINJA&TF  BRZE|二合一:恐龙战队系列|Power Rangers - Ninja Storm + Power Rangers - Time Force (U)
BIONICLE    BILE|生化战士：影子困惑|Bionicle - Maze of Shadows (U)
GAUNTLETCOMPB69E|火力壁垒|Gauntlet, Rampart (U)
MILLIPEDECOMB62E|小游戏三合一|Millipede, Super Breakout, Lunar Lander (U)
PRANGERS_SPDBRDE|恐龙战队|Power Rangers S.P.D. (UE)
RAYMAN 10TH BX5E|雷曼十周年|Rayman 10th Anniversary - Rayman Advance + Rayman 3 (U)
SCOOBYUN    B25E|史努比揭下的面具|Scooby-Doo! Unmasked (U)
SPYHUNTCOMP B6AE|小游戏二合一|Spy Hunter, Super Sprint (U)
TAK GJC     BJWE|塔克：伟大的符咒挑战|Tak - The Great Juju Challenge (UE)
SUPERPAKVOL4BBEE|芭比秘密间谍|Barbie Groovy Games + Secret Agent Barbie (U)
TGRALLY     BTGP|顶极拉力|TG Rally (E)
DANNYPHANTOMBUEE|幻影丹尼:：终极敌人|Danny Phantom - The Ultimate Enemy (U)
Whac-A-Mole BWEE|Whac-a-Mole|Whac-A-Mole (U)
CINDBCDE    BCDE|迪士尼之灰姑娘|Cinderella - Magical Dreams (U)
HWVX HWWR   BHZE|火热车轮双合集|2 in 1 - Hot Wheels - Velocity X + Hot Wheels - World Race (U)
SCREWBREAKERV49J|螺旋破坏者-轰振钻子|Screw Breaker - Goushin Dorirurero (J)
SPOOKY TREE BBOE|贝贝熊与老树精|Berenstain Bears and the Spooky Old Tree, The (U)
ULTSPIDERMANBULE|终极蜘蛛侠|Ultimate Spider-Man (U)
ONEPIECE    BONE|海贼王|One Piece (U)
FIFA 06     BF6E|FIFA2006|FIFA 06 (UE)
BIBIBLOCKSB2BBXD|比比小魔女|Bibi Blocksberg - Der magische Hexenkreis (G)
ODDPARENTS  BFOE|反斗家族|Fairly Odd Parents!, The - Clash with the Anti-World (U)
SUPER MARIODAX4E|超级马力奥4|Super Mario Advance 4 - Super Mario Bros. 3 (UA)
SUPERPAKVOL4BBEP|芭芘娃娃超级合集|Barbie Groovy Games + Secret Agent Barbie (E)
PAC WORLD 2 B2CE|吃豆人世界2|Pac-Man World 2 (U)
GUNSTAR SH  BGXJ|火枪英雄|Gunstar Super Heroes (J)
MEGAMANZERO4B4ZE|洛克人Zero4|Megaman Zero 4 (U)
BRATZ ROCK ABRRE|摇滚天使|Bratz - Rock Angelz (U)
NIGHTMARE   BNCE|圣诞夜惊魂：南瓜王|The Nightmare Before Christmas - The Pumpkin King (UE)
BYSK8NG2006 BS6E|后院滑板|Backyard Skateboarding (U)
EVERGIRL    BEVE|Evergirl|Ever Girl (U)
CHICKENSHOOTB6FP|猎鸡|Chicken Shoot (E)
DRIVER3     B3RP|车神3|Driv3r (E)
ULTSPIDERMANBULX|终极蜘蛛侠|Ultimate Spider-Man (E)
HITOFUDEGBA BIIJ|一笔交替|Tsuukin Hitofude (J)
YUGIOHDMGX  BYGJ|游戏王：决斗大师GX目标：双重冠军|Yu-Gi-Oh! - Duel Monsters GX - Mezase Duel King (J)
TEENTITANS  BBLE|少年悍将|Teen Titans (U)
LUR2        BYPP|牧场生活２|Horse & Pony - Let's Ride 2 (E)
POKEPIN R/S BPPJ|口袋弹珠台　红/蓝宝石版|Pokemon Pinball - Ruby & Sapphire (J)
MADAGASCAR  BGZI|马达加斯加|Madagascar (I)
FANTASTIC4  BF4I|神奇四侠|Fantastici 4, I (I)
KIDS CARDS  BCXE|儿童卡片|Kid's Cards (U)
CARTONETW004MCSE|卡通网络特别收藏版|Cartoon Network Collection - Special Edition (U)
DM SHADOW   BDUP|决斗大师影子代号|Duel Masters - Shadow of the Code (E)
BREAKOUTCENTB6ZP|突围、蜈蚣、都督|Breakout, Centipede, Warlords (E)
POKEMON EMERBPED|口袋妖怪绿宝石|Pokemon - Smaragd-Edition (G)
CRASH & SPYRB53P|古惑狼与斯派洛超级包3|Crash & Spyro 3 - Spyro Fusion + Crash Bandicoot Fusion (E)
POKEMON EMERBPEF|口袋妖怪绿宝石|Pokemon - Version Emeraude (F)
BYF 2006    BYFE|后院足球2006|Backyard Football 2006 (U)
PENGUINS    BM7E|马达加斯加-企鹅行动|Madagascar - Operation Penguin (U)
POKEMON EMERBPES|口袋妖怪绿宝石|Pokemon - Edicion Esmeralda (S)
WPT2K6      B26E|世界扑克巡回大赛|World Poker Tour (U)
DM SHADOW   BDUE|决斗大师影子代码|Duel Masters - Shadow of the Code (U)
SBSPLIGHTS  BQQE|海绵方块灯光、照相、内裤！|SpongeBob SquarePants - Lights, Camera, Pants! (U)
TH SK8LAND  BH9E|托尼霍克美式滑板|Tony Hawk's American Sk8land (U)
PAPERBOYRAMPB6BP|送报童&金刚|Paperboy, Rampage (E)
CRASH S PACKB8AE|古惑狼超级包|Crash Bandicoot 2 - N-Tranced + Crash Nitro Kart (U)
HUGO 2IN1   B2HP|2合一雨果包|2 in 1 - Hugo - Bukkazoom! + Hugo - The Evil Mirror (E)
PENGUINS    BM7X|马达加斯加|Madagascar - Operation Penguin (E)
GUNSTAR SH  BHGE|超级火枪英雄|Gunstar Super Heroes (U)
FRONTIERST  BCMJ|终极物语|Frontier Stories (J)
KUNIKORE02  B9BJ|国夫君热血纪念馆2|Kunio Kun Nekketsu Collection 2 (J)
BARBIE PEGASBE5P|芭比和魔法天马|Barbie and the Magic of Pegasus (E)
CLITTLEE    BCHE|四眼天鸡|Chicken Little (UE)
ULT ARCADE  BUZE|终极街机游戏|Ultimate Arcade Games (U)
THE SIMS 2  B46E|模拟人生2|Sims 2, The (UE)
CARE_BEARS  BEAP|爱心熊之爱心任务|Care Bears - The Care Quests (E)
POKEMON EMERBPEI|口袋妖怪绿宝石|Pokemon - Versione Smeraldo (I)
W.I.T.C.H.  BWTP|女巫|W.i.t.c.h. (E)
SPACE INVADEAIDF|太空侵略者|Space Invaders (F)
DRIVER3     B3RE|极道无间3|Driv3r (U)
NICKTOONSUNIBNUE|尼克通|Nicktoons Unite! (U)
SKYDANCERS  B4DE|空中之舞魔法飞翔|Sky Dancers - They Magically Fly! (U)
DRMARIO&PONPBZPP|2合一任天堂包|2 in 1 - Dr. Mario & Puzzle League (E)
RAREDKC3    BDQP|大金刚3|Donkey Kong Country 3 (E)
FIREEMBLEM2PBE8P|火焰纹章圣魔之石|Fire Emblem - The Sacred Stones (E)
GAUNTLETRAMPB69P|射击，堡垒|Gauntlet, Rampart (E)
2IN1_ADV_PINBW5P|2合一索尼克包Vol.1|2 in 1 - Sonic Advance + Sonic Pinball Party (E)
BIGMTRUCKER B63E|大脚怪赛车|Big Mutha Truckers (U)
RAREDKC3    BDQE|大金刚世界3|Donkey Kong Country 3 (UA)
TY3         BTVE|泰斯虎冒险3|Ty the Tasmanian Tiger 3 - Night of the Quinkan (U)
GUNSTAR FH  BHGP|超级火枪英雄|Gunstar Future Heroes (E)
POTTER G.O.FBH8E|哈利波特和火焰杯|Harry Potter and the Goblet of Fire (UE)
SUPER SLAM  B4UE|史瑞克超级撞击|Shrek - Super Slam (U)
2IN1_COL_CHUBW9P|2合一世嘉包Vol2|2 in 1 - Columns Crown + Chu Chu Rocket! (E)
KLAXMARBLE  B68P|疯狂弹珠、立体方块|Marble Madness, Klax (E)
2IN1_BTL_PINBW6P|2合一索尼克包Vol2|2 in 1 - Sonic Pinball Party + Sonic Battle (E)
2IN1_ADV_BTLBW4P|2合一索尼克包Vol3|2 in 1 - Sonic Advance + Sonic Battle (E)
INCREDBLROTUBIQX|超人特工队|Incredibles, The - Rise of the Underminer (E)
LILO & STITCBLQP|2合一小飞侠和星际宝贝2|2 in 1 - Lilo & Stitch 2 + Peter Pan - Return to Neverland (E)
BIBLE GAME  BIBE|圣经游戏|Bible Game, The (U)
KINGKONG GBABKQP|金刚|King Kong - The Official Game of the Movie (E)
FORDRACING3 BF3E|福特赛车3|Ford Racing 3 (U)
TH SK8LAND  BH9X|托尼霍克美式滑板|Tony Hawk's American Sk8land (E)
SUPER SLAM  B4UP|史瑞克超级碰撞|Shrek - Super Slam (E)
SBSPLIGHTS  BQQX|海绵方块|SpongeBob SquarePants - Lights, Camera, Pants! (E)
ODDPARENTS  BFOP|正义双亲|Fairly Odd Parents!, The - Clash with the Anti-World (E)
POKE DUNGEONB24J|口袋妖怪不可思议的迷宫红色救助队|Pocket Monsters - Fushigi no Dungeon Aka no Kyuujotai (J)
MARIOTENNISABTMP|马力奥网球|Mario Power Tennis (E)
ATOMIC BETTYBETE|超级贝蒂|Atomic Betty (UE)
HELLOKITTY  B86E|哈罗！凯蒂快乐聚会|Hello Kitty - Happy Party Pals (U)
F4 FLAME ON BH4E|神奇四侠|Fantastic 4 - Flame On (U)
SPYHUNTSUPERB6AP|间谍猎人和超级冲刺|Spy Hunter, Super Sprint (E)
NARNIA LWW  B2WE|纳尼亚编年史|Chronicles of Narnia - The Lion, The Witch and the Wardrobe (UE)
LUNARLANDER B62P|蜈蚣打砖块登月|Millipede, Super Breakout, Lunar Lander (E)[b]
ASTEROIDPONGB64P|小游戏3合一|Pong, Asteroids, Yars' Revenge (E)
BRATZ ROCK ABRRD|贝兹摇滚天使|Bratz - Rock Angelz (G)
TOTALLYSPIESBTUP|神探少女组|Totally Spies! (E)
NFSMW       BNWE|极品飞车最高通缉|Need for Speed - Most Wanted (UE)
INCREDBLROTUBIQE|超人特攻队|Incredibles, The - Rise of the Underminer (UE)
ULTIMATE PUZBUAE|终极智力游戏|Ultimate Puzzle Games (U)
ROCKEXE6_RXXBR6J|洛克人EXE6电脑兽法尔扎|Rockman EXE 6 - Dennoujuu Faltzer (J)
ROCKEXE6_GXXBR5J|洛克任EXE6电脑兽格莱伽|Rockman EXE 6 - Dennoujuu Grega (J)
WINXCLUB    BWIP|神奇飞仙|WinX Club (E)
TIERPENSION BQTP|我的宠物旅馆|My Pet Hotel (E)
SHAMUSADV   BBAE|海洋世界：深海冒险|Shamu's Deep Sea Adventures (U)
TROLLZHAIRAFBT6E|奇幻漫舞|Trollz - Hair Affair! (U)
TROLLZHAIRAFBOFD|大象弹珠台|Ottifanten Pinball (G)
DYN WARS ADVB36P|真·三国无双A|Dynasty Warriors Advance (E)
DRMARIO&PONEBZPE|马里奥医生和拼图联盟|2 in 1 - Dr. Mario & Puzzle League (UA)
FRANKLIN    BFLP|富兰克林之伟大的冒险|Franklin's Great Adventures (E)
PENGUINS    BM7Y|马达加斯加之企鹅行动|Madagascar - Operation Penguin (E)
CRAZY FROG KBCRP|疯狂青蛙赛车|Crazy Frog Racer (E)
FRANKLIN    BFKE|小海龟富兰克林|Franklin the Turtle (U)
CARE_BEARS  BEAE|爱心熊宝宝之爱心城堡|Care Bears - The Care Quests (U)
PROUDFAMILYGBD7E|骄傲家族|Proud Family, The (U)
LBT_ITMB    BLOP|小脚板走天涯|Land Before Time, The - Into the Mysterious Beyond (E)
SYUGA2 HEARTB4LJ|魔女的考验|Sugar Sugar Rune - Heart Ga Ippai! Moegi Gakuen (J)
RAREDKC3    BDQJ|超级大金刚3|Super Donkey Kong 3 (J)
GASH-ZAKERU3BUDJ|金色卡修！！友情之电击梦幻比赛|Konjiki no Gashbell!! Dream Tag Tournament (J)
MARIOTENNISABTME|马里奥超级网球巡回赛|Mario Tennis - Power Tour (UA)
CRAFTSWORD HB3CJ|召唤之夜：铸剑物语3起源之石|Summon Night - Craft Sword Monogatari - Hajimari no Ishi (J)
FF4ADVANCE  BZ4J|最终幻想4|Final Fantasy IV Advance (J)
FF4ADVANCE  BZ4E|最终幻想4|Final Fantasy IV Advance (UA)
SHORTCAKEIRCB35P|草莓娃娃之冰淇淋大陆的露营|Strawberry Shortcake - Ice Cream Island - Riding Camp (E)
HEIDI       BHJP|海蒂|Heidi - The Game (E)
DOGZ        B82E|狗狗|Dogz (U)
EEE2        BEDE|艾艾德艾迪-阴差阳错|Ed, Edd n Eddy - The Mis-Edventures (U)
ELFBOWL     BEBE|精灵保龄球1+2|Elf Bowling 1 & 2 (U)
KINGKONG GBABKQE|金刚世界第八奇迹|Kong - The 8th Wonder of the World (U)
SNOOD2ONVAC B2VP|怪投射波|Snood 2 - Snoods on Vacation (E)
TOTALLYSPIESBTUE|全能间谍|Totally Spies! (U)
ZATCH EA1   A4GE|金色卡修|Zatchbell! - Electric Arena (U)
HUBEST_VOL03B73J|HUDSON经典游戏第三辑|Hudson Best Collection Vol. 3 - Action Collection (J)
TWIN SERIES1BFVJ|双子系列第一辑|Mezase Debut! Fashion Designer + Kawaii Pet Game Gallery 2 (J)
HI HI PUFFYABHHE|嗨，帕妃亚美和由美|Hi Hi Puffy AmiYumi - Kaznapped! (U)
DBZLEGACY1&2BLFE|龙珠Z1+2|2 in 1 - Dragon Ball Z - The Legacy of Goku I & II (U)
KONG:KOA    BK7E|金刚亚特兰蒂斯之主|Kong - King of Atlantis (U)
PENGUINS    BM7P|马达加斯加|Madagascar - Operation Penguin (E)
GARFIELDTSFPBGOE|加菲猫寻找波基|Garfield - The Search for Pooky (U)
SEA MONKEYS A7ME|虚拟海猴|Amazing Virtual Sea-Monkeys, The (U)
TTABBD      ATTE|兔宝贝历险记惊梦|Tiny Toon Adventures - Scary Dreams (U)
LA FAMILLE DAWLF|丛林家庭|Famille Delajungle, La - Le Film (F)
2IN1_ADV_PINBW5E|索尼克游戏二合一|2 in 1 - Sonic Advance + Sonic Pinball Party (U)
OCHAKENISLANBO2J|茶犬的冒险岛|Ochaken no Bouken Jima - Honwaka Yume no Island (J)
HI HI PUFFYABHHJ|嗨帕妃亚美由美|Hi Hi Puffy AmiYumi (J)
PLAYYANMICROZMBJ|Play-Yan Micro (J)|Play-Yan Micro (J)
CV 2 PACK   BXKE|恶魔城2合1|Castlevania - Harmony of Dissonance + Aria of Sorrow (U)
POCKETDOGS  BTDE|口袋小狗|Pocket Dogs (U)
WINXCLUB    BWIE|神奇飞仙|WinX Club (U)
YUGIOHGXDA  BYGE|游戏王GX决斗学院|Yu-Gi-Oh! GX - Duel Academy (U)
LOONEYTUNES2BLNP|华纳明星总动员2合1|Looney Tunes - Dizzy Driving + Acme Antics (E)
GHTP MAXD   BGQE|格雷戈哈斯汀彩弹竞技场|Greg Hastings' Tournament Paintball MAXd (U)
HELLOKITTY  B86X|哈罗凯蒂！快乐聚会|Hello Kitty - Happy Party Pals (E)
GEORGE      B3JE|好奇的乔治|Curious George (U)
WILDEKERLE01BWUD|戴维德足球|Wilden Fussball-Kerle, Die (G)
DRILL DOZER V49E|螺旋钻地小子|Drill Dozer (U)
WINTERSPIELEBWYP|冬季运动|Winter Sports (E)
ALIENHOMINIDBAHP|外形原人|Alien Hominid (E)
CN SPEED&BLKBW2P|2合一卡通网络黑色聚会和赛车|Cartoon Network Block Party + Cartoon Network Speedway (E)
BIGMTRUCKER B63P|重金属卡车|Big Mutha Truckers (E)
FORDRACING3 BF3P|福特赛车3|Ford Racing 3 (E)
PRANGERS_SPDBRDX|雷霆战队空间巡逻三人组|Power Rangers S.P.D. (E)(Eng-Fre-Ger)
SUDOKU FEVERB3ZE|填字解谜|Global Star - Sudoku Fever (U)
SHAMAN KING2B2MP|通灵王精神大师2|Shaman King - Master of Spirits 2 (E)
SBSPUNITE   BNUP|海绵方块和他的朋友们|SpongeBob SquarePants and Friends Unite! (E)
CV 2 PACK   BXKP|恶魔城2合一|Castlevania - Harmony of Dissonance + Aria of Sorrow (E)
TAK GJC     BJWX|塔克-伟大的符咒挑战|Tak - The Great Juju Challenge (E)
3IN1 RECROOMBRQP|飞标竞技3合1|3 in 1 - Darts + Roll-a-Ball + Shuffle Bowl (E)
YUGIOHDMEX06BY6J|游戏王决斗怪兽EX2006|Yu-Gi-Oh! - Duel Monsters Expert 2006 (J)
KIMPOSSIBLE2BKMP|迪斯尼麻辣女孩２|Kim Possible 2 - Drakken's Demise (E)
PAWSANDCLAWSBURE|我的宠物旅馆|Paws & Claws - Pet Resort (U)
DISNEY FB SBBFBP|2合一迪斯尼运动包|Disney Sports - Football + Disney Sports - Skateboarding (E)
NEMOINCREDIBBIND|海底总动员&超人特工队|2 in 1 - Findet Nemo + Unglaublichen, Die (G)
NEMO NEMO2  BFWY|海底总动员合集|Findet Nemo + Findet Nemo - Das Abenteuer geht weiter (E)
KONGATLANTISBK7P|金刚亚特兰蒂斯|Kong - King of Atlantis (E)
SUPER MARIOCA3AC|超级玛丽奥３-耀西之岛|Yaoxi Dao (C)
METFUSIONCHNAMTC|密特罗德融合|Miteluode Ronghe (C)
PHANTASIA   AN8E|幻想传说|Tales of Phantasia (UA)
HOLDM&CASINOBWCP|2合一金块与德克萨斯扑克|2 in 1 - Golden Nugget Casino + Texas Hold'em Poker (E)
TRUCKS&QUAD BWQP|2合一越野车&怪兽卡车|2 in 1 - Quad Desert Fury + Monster Trucks (E)
NARUTO US1  A7AE|火影忍者忍者大集结|Naruto - Ninja Council (U)
AKAGI       BZWJ|赤木麻将传说|Akagi (J)
HUBEST_VOL06B76J|Hudson经典收藏6|Hudson Best Collection Vol. 6 - Bouken Jima Collection (J)
UEKIJINGIBTLBUHJ|植木的法则|Ueki no Housoku - Jingi Sakuretsu! Nouryokusha Battle (J)
SCOOBYUN    B25X|史努比揭下的面具|Scooby-Doo! Unmasked (E)
KUNIKORE03  B9CJ|国夫君热血典藏3|Kunio Kun Nekketsu Collection 3 (J)
ICE AGE 2   BIAE|冰河世纪2|Ice Age 2 - The Meltdown (U)
YUGIOH 2IN1 BY2P|2合一游戏王系列|Yu-Gi-Oh! - Reshef of Destruction + The Sacred Cards (E)
TMNT GBA 1+2BT8P|2合一忍者神龟|Teenage Mutant Ninja Turtles + Battle Nexus (E)
YUGIOHWCT06 BY6E|游戏王！终极大师2006|Yu-Gi-Oh! - Ultimate Masters - WCT 2006 (U)
KAWANUSHI 34BN4J|川之垂钓3&4|Kawa no Nushi Tsuri 3 & 4 (J)
3N1SPORTSPAKB3NP|3合一Majesco体育包|Paintball Splat! + Dodgeball + Big Alley Bowling (E)
YUGIOHWCT06 BY6P|游戏王！世界冠军挑战赛2006|Yu-Gi-Oh! - Ultimate Masters Edition - WCT 2006 (E)
PAWAPOKED1  BBQJ|口袋力量棒球冲刺|Power Poke Dash (J)
YGGDRA UNIONBYUJ|优达拉联盟|Yggdra Union (J)
THE TOWER SPBTRE|高楼大厦SP|Tower SP, The (U)
CATZ        AN3E|猫|Catz (UE)
PHANTASIA   AN8P|幻想传说|Tales of Phantasia (E)
STREETRACINGBCZE|街头赛车|Street Racing Syndicate (U)
ICE AGE 2 THBIAP|冰河世纪2|Ice Age 2 - The Meltdown (E)
TOP SPIN 2  B27E|上旋高手2|Top Spin 2 (U)
RIDE DREAMERBL9E|骑马梦想者　|Let's Ride! - Dreamer (U)
SUDOKU FEVERB3ZP|填字解谜|Global Star - Sudoku Fever (E)
LET'S RIDEUSB34E|让我们骑马吧|Let's Ride! - Sunshine Stables (U)
SUPER MARIOBAA2C|超级玛丽奥２|Chaoji Maliou Shijie (C)
WPT2K6      BWOP|世界扑克巡回大赛|World Poker Tour (E)
YUGIOHWWE   AYWJ|游戏王6-国际版|Yu-Gi-Oh! - Duel Monsters - International Worldwide Edition (J)
KURESHIN2004BKCS|蜡笔小新-电影乐园大冒险|Shinchan - Aventuras en Cineland (S)
NAMCO 50    B5NP|南梦宫博物馆50周年|Namco Museum - 50th Anniversary (E)
POLARIUMGBA BIIP|直感一笔|Polarium Advance (E)
EEE2        BEDP|艾艾德艾迪-阴差阳错|Ed, Edd n Eddy - The Mis-Edventures (E)
ELF         BELP|公司|Elf - The Movie (E)
THE WILD    BWLE|狂野大自然|Wild, The (UE)
KURESHIN2006BC2J|蜡笔小新2|Shin-chan - Densetsu wo Yobu Omake no Miyako Shockgaan! (J)
NEMO_MON_FREBDZF|怪物工厂&海底总动员|2 in 1 - Monstres & Cie + Monde de Nemo, Le (F)
F4 FLAME ON BH4P|神奇四侠|Fantastic 4 - Flame On (E)
EYESHIELDGBABE4J|极速达阵21恶魔蝙蝠恶魔日|Eyeshield 21 Devilbats Devildays (J)
NANPURE     BUOJ|大众软件系列数独|Minna no Soft Series - Numpla Advance (J)
BOF1        ABFP|龙战士|Breath of Fire (E)
KAWAIIKONEKOAN3J|上旋高手2|Nakayoshi Pet Advance Series 3 - Kawaii Koneko (J)
SONICADVANCEASOJ|可爱宠物系列３-可爱小猫|Sonic Advance (J)
TOP SPIN 2  B27P|索尼克大冒险|Top Spin 2 (E)
SCOOBYUN    B25Y|史努比揭下的面具|Scooby-Doo! Unmasked (E)(Ita-Spa)
MOTHER3     A3UJ|妈妈3|Mother 3 (J)
CABBAGE PATCBCGE|卷心菜娃娃|Cabbage Patch Kids - The Patch Puppy Rescue (U)
LBT_ITMB    BLOE|小脚板走天涯|Land Before Time, The - Into the Mysterious Beyond (U)
FRANKLIN    BFLE|小海龟富兰克林|Franklin's Great Adventures (U)
DANNYPHANTOMBUEX|幻影丹尼:：终极敌人|Danny Phantom - The Ultimate Enemy (E)(Eng-Ger-Spa)
TITEUF DUO  BT5F|2合一|2 in 1 - Titeuf - Ze Gagmachine + Titeuf Mega Compet (F)
FIFA WC     B6WE|FIFA2006世界杯|FIFA World Cup Germany 2006 (UE)
KONCYUNOMORIBQKJ|昆虫之森大冒险|Fushigina Sekai no Junin Tachi (J)
HUBEST_VOL01B7IJ|Hudson纪念馆1|Hudson Best Collection Vol. 1 - Bomberman Collection (J)
NEMOINCREDIBBINP|2合一海底总动员超人特工队|2 in 1 - Finding Nemo + Incredibles, The (E)
DRAGONS ROCKBJDP|龙之洛克|Dragon's Rock (E)
POP&LARA    B2QP|波斯王子和古墓丽影|Prince of Persia + Tomb Raider - The Prophecy (E)
KOALA_BROS  BAKE|熊兄弟|Koala Brothers - Outback Adventures (U)
JUKA        BJKP|Juka与Monophonic危机|Juka and the Monophonic Menace (E)
PMWANDMPMMM B6PP|2合一吃豆小姐和吃豆先生|2 in 1 - Pac-Man World + Ms. Pac-Man - Maze Madness (E)
DOCTORSUDOKUBUOE|数独|Dr. Sudoku (U)
CANEPREMFR00MCPF|GBA卡通电影集合|Cartoon Network Collection - Edition Premium (F)
SPYRO S PACKB8SE|小龙斯派罗超级合集|Spyro - Season of Ice + Spyro 2 - Season of Flame (U)
ZOKTAI      U32J|我们的太阳续集-太阳少年加戈|Zoku Bokura no Taiyou - Taiyou Shounen Django (J)
OVER THE HEDBH5E|篱笆墙外|Over the Hedge (U)
TRINGO      BTJE|Tringo|Tringo (U)
MADAGASCAR  BGZJ|马达加斯加|Madagascar (J)
HUBEST_VOL04B74J|哈德森精选集4|Hudson Best Collection Vol. 4 - Nazotoki Collection (J)
2IN1_BTL_PINBW6J|2合一索尼克包Vol2|2 in 1 - Sonic Pinball Party + Sonic Battle (J)
2IN1_ADV_BTLBW4J|2合一索尼克包Vol3|2 in 1 - Sonic Advance + Sonic Battle (J)
CANDYLAND CHBC4E|糖果岛,蛇棋游戏,记忆|Candy Land, Chutes and Ladders, Memory Game (U)
THE GAME OF B3UE|生存,骰子五连星,发薪日|Life, Yahtzee, Payday (U)
NEGIMAGI2   BNMJ|魔法老?正太先生涅吉!私人授?2|Mahou Sensei Negima! - Private Lesson 2 (J)
X-MEN: THE OB3XE|X?警-官方游?|X-Men - The Official Game (U)
CALCIOBIT01 BIXJ|??玩??足球|Calciobit (J)
ANIYOKO2    BAXJ|?物?町-心跳心跳升?考?之卷|Animal Yokochou - Doki Doki Shinkyuu Shiken! no Kan (J)
HUBEST_VOL02B72J|任天堂??Hudson?典收藏2-智力篇|Hudson Best Collection Vol. 2 - Lode Runner Collection (J)
ANIYOKO     BAYJ|?物?町-心跳心跳救出大作?之卷|Animal Yokochou - Doki Doki Kyushutsu Daisakusen ! no Maki (J)
PANZOU      B3IJ|神奇?幻熊?警官七?星球的宇宙海?|Mirakuru! Panzou - 7tsu no Hoshi no Uchuukaizoku (J)
CHICKENSHOT2B6GE|射?英雄?2|Chicken Shoot 2 (U)
BASEBALL2007BC7E|後院??-棒球2007|Backyard Sports - Baseball 2007 (U)
GARFIELD    BG9E|加菲??找波基|Garfield and His Nine Lives (U)
BB-DAMA2FIREBBMJ|B-??!??比?人炎魂|B-Densetsu! Battle B-Daman - Fire Spirit! Honootamashii! (J)
CINNAMOROLL3B43J|?耳狗希?蒙-?上大作?|Cinnamon Game Series 3 - Fuwafuwa Daibouken (J)
X-MEN: THE OB3XP|X?警|X-Men - The Official Game (E)
FF4ADVANCE  BZ4P|最?幻想4|Final Fantasy IV Advance (E)
CHICKENSHOT1B6FE|射?英雄?1|Chicken Shoot (U)
HARDCOREPOOLBHOP|核心?球|Hardcore Pool (E)
RACING FEVERBRWP|火???|Racing Fever (E)
CRA&SPYSPACKB53E|游?2合1-???等|Crash Bandicoot - Ripto's Rampage + Spyro- Cortex Conspiracy (U)
ULTSPIDERMANBULP|??蜘蛛?|Ultimate Spider-Man (E)
DIS PIX CARSBCAE|汽????|Cars (U)
BABAR_TTR   BBVE|?巴-救援|Babar to the Rescue (U)
TH SK8LAND  BH9P|托尼霍克美式滑板|Tony Hawk's American Sk8land (E)
DRAGONBALLAABDVE|?珠大冒?|Dragon Ball - Advanced Adventure (U)
MEGAMAN6_GXXBR5E|洛克人????EXE6-???格?伽|Megaman Battle Network 6 Cybeast Gregar (U)
MEGAMAN6_GXXBR5P|洛克人????EXE6-???格?伽|Megaman Battle Network 6 Cybeast Gregar (E)
MEGAMAN6_FXXBR6P|洛克人????EXE6-???法?????Megaman Battle Network 6 Cybeast Falzar (E)|
CINDBCDE    BCDP|迪士尼之灰姑娘|Cinderella - Magical Dreams (E)
OVERTHEHEDGEBH5D|?笆?????森林保??|Ab durch die Hecke (G)
ANSTOSS     BAQP|足球?理|Premier Action Soccer (E)
GARFIELD    BG9P|加菲??找波基|Garfield and His Nine Lives (E)
TAK_RUG_SSPOB44P|游?3合1-淘?小兵等等|Rugrats + SpongeBob SuperSponge + Tak and the Power of Juju (E)
PIRATESDMC  B8QE|加勒比海?2亡者??|Pirates of the Caribbean - Dead Man's Chest (UE)
MEGAMAN6_FXXBR6E|洛克人????EXE6-???法?????Megaman Battle Network 6 Cybeast Falzar (U)|
YUGIOH 2IN1 BY2E|2合一游?王系列|Yu-Gi-Oh! - Reshef of Destruction + The Sacred Cards (U)
P PROF 1    BPJE|口袋教授-克威克??第1部|Pocket Professor - Kwik Notes - Vol. 1 (U)
SRS - STREETBCZP|街????盟|Street Racing Syndicate (E)
TIERPRAXIS  BQVP|我的????|Meine Tierarztpraxis (E)
PENGUINS    BM7S|??加斯加|Madagascar - Operacion Pinguino (S)
BOUNDISH    BVDJ|?何世代-反??球|bit Generations - Boundish (J)
DIALHEX     BVBJ|?何世代-六角形??|bit Generations - Dialhex (J)
DOTSTREAM   BVCJ|?何世代-??潮流|bit Generations - Dotstream (J)
MONSTERHOUSEBQ7E|怪?小屋|Monster House (U)
OVERTHEHEDGEBH5S|?笆?????森林保??|Vecinos Invasores (S)
CLITTLEJ    BCHJ|迪斯尼四眼天?|Chicken Little (J)
HUBEST_VOL05B75J|任天堂??系列??篇|Hudson Best Collection Vol. 5 - Shooting Collection (J)
CARSAGB     BCAJ|汽????|Cars (J)
YUGIOHGXDA  BYGP|游?王GX?斗?院|Yu-Gi-Oh! GX - Duel Academy (E)
SOUNDVOYAGERBVGJ|?何世代-?音航海家|bit Generations - Soundvoyager (J)
ORBITAL     BVEJ|?何世代-?道??牽??bit Generations - Orbital (J)|
DIGIDRIVE   BVHJ|?何世代-?位??|bit Generations - Digidrive (J)
COLORIS     BVAJ|?何世代-?色方?|bit Generations - Coloris (J)
THEANTBULLY BUYE|?惹??|Ant Bully, The (U)
2IN1_ADV_CHUBW3J|游?2合1索尼克和火箭?|2 in 1 - Sonic Advance + Chu Chu Rocket! (J)
HAMSTAR3EX4 BHSJ|?鼠物?3EX4特?版|Hamster Monogatari 3EX 4 Special (J)
SUMMONIGHSCSAB4E|召?之夜-??物?1|Summon Night - Swordcraft Story (U)
NEMO NEMO2  BFWP|海底???合集|Finding Nemo + Finding Nemo - The Continuing Adventures (E)
MR.I UM     BIQJ|超人特攻?|Mr. Incredible - Kyouteki Underminer Toujou (J)
BARNYARD    BBYE|?狂??|Barnyard (U)
RHYTHMTENGOKBRIJ|?奏天?-旋律天堂|Rhythm Tengoku (J)
BB-DAMAN    BDXE|碰球??|Battle B-Daman (U)
SCRABBLE SCRBLAX|混?拼字游?|Scrabble Scramble (E)
BABAR_TTR   BBVP|?巴-救援|Babar to the Rescue (E)
BAD APPLE   BZTE|蔬菜???-拉?男孩和??果|VeggieTales - LarryBoy and the Bad Apple (U)
SRTOG       AOGE|超??器人大?-原?世?|Super Robot Taisen - Original Generation (U)
ROBOTS      BRTJ|?器人|Robots (J)
MONSTERHOUSEBQ7X|怪物之屋|Monster House (E)
GAMEEXPLSIONBG7E|游?爆?|Games Explosion! (U)
MADDEN 2007 B7ME|?狂橄?球2007|Madden NFL 07 (U)
BUUGTCOLLECTBUFE|?珠2合1|Dragon Ball Z - Buu's Fury + Dragon Ball GT - Transformation (U)
DIS PIX CARSBCAD|汽????|Cars (G)
DR. SUDOKU  BUOP|??博士|Dr. Sudoku (E)
THEANTBULLY BUYP|?惹??|Ant Bully, The (E)
YUGIOHDPACK2BYVE|游?王2合1|Yu-Gi-Oh! - Destiny Board Traveler + Dungeon Dice Monsters (U)
DIS PIX CARSBCAI|汽????|Cars (I)
SWORD OF MANAVSP|新?-????|Sword of Mana (E)
LSW2GBA     BL7E|?高星球大?2-原力|LEGO Star Wars II - The Original Trilogy (U)
LK_AND_DPIT BLPI|迪斯尼2合1|2 in 1 - Disney Principesse + Re Leone, Il (I)(Ita+M8)
LEINSTEINS  BEIE|小?因斯坦|Little Einsteins (U)
CHEETAHGIRLSBCQE|花豹美眉|Cheetah Girls, The (U)
LSW2GBA     BL7P|?高星球大?2-原力|LEGO Star Wars II - The Original Trilogy (E)
OPEN SEASON BOAE|狩?季?|Open Season (U)
POKE DUNGEONB24E|口袋妖怪不可思?的迷?-?色救助?|Pokemon Mystery Dungeon - Red Rescue Team (UA)
BARNYARD    BBYX|?狂??|Barnyard (E)
MYLITTLEPONYBL6E|小精??-水晶公主|My Little Pony - Crystal Princess - The Runaway Rainbow (U)
DANNYPHANTOMBQYE|丹尼幻影-???人|Danny Phantom - Urban Jungle (U)
CAPCOMINIMIXBC6E|?自未?的菲????Capcom Classics Mini Mix (U)|
PHILOFUTURE BFXE|卡普空?典合集迷你混合版|Phil of the Future (U)
DOGZ FASHIONBFEE|狗狗?尚|Dogz - Fashion (U)
FIFA 07     B7FE|FIFA足球2007|FIFA 07 (U)
CATZ        AN3X|?物?|Catz (E)
ALEX RIDER  BAWE|阿?克斯?德-?暴??者|Alex Rider - Stormbreaker (U)
BBASKET2007 BB7E|室???-?球2007|Backyard Sports - Basketball 2007 (U)
BYF 2007    BF7E|室???-足球2007|Backyard Sports - Football 2007 (U)
SWEET DREAMSB4TE|草莓脆?-美?|Strawberry Shortcake - Sweet Dreams (U)
UNFABULOUS  BU4E|不可思?|Unfabulous (U)
AM DRAGON   BAPE|美??-杰克?|American Dragon - Jake Long - Rise of the Huntsclan! (UE)
BIBITINA01  BUXD|比比和提娜-在牧?的三月假日|Bibi und Tina - Ferien auf dem Martinshof (G)
LITLEMERMAIDBN9E|小美人?艾?????暮５酌半U|Little Mermaid, The - Magic in Two Kingdoms (U)
FF5ADVANCE  BZ5J|最?幻想5|Final Fantasy V Advance (J)
BB_&_DP_FRE_BWBF|迪斯尼美女?野?2合1|2 in 1 - Disney Princesse + Frere des Ours (F)
BRATZ ROCK ABRRF|布拉?-??天使|Bratz - Rock Angelz (F)
MEIN GESTUETBHUP|匹菲????潞筒??Pferd & Pony - Mein Gestuet (E)|
BB-DAMA2FIREBBME|B-??!??比?人炎魂|Battle B-Daman - Fire Spirits (U)
SCOOBYMOVIEEAP8S|史努比|Scooby-Doo (S)
PRINCESSTOWNBQNE|迪斯尼公主-皇家冒?|Disney Princess - Royal Adventure (U)
NARUTO US2  BN2E|火影忍者-忍者大集合2|Naruto - Ninja Council 2 (U)
HAMMYGOSNUTSBH7E|?笆?????Over the Hedge - Hammy Goes Nuts! (U)|
FAMILY FEUD B2FE|全民?答|Family Feud (U)
AVATAR      BQZE|降世神通|Avatar - The Last Airbender (U)
UNOUNOSKIPBOBUQE|?牌2合1|2 in 1 - Uno + Skip-Bo (U)
ROCKEMSOCKEMBR7E|?器人格?|Rock'em Sock'em Robots (U)
SANTACLAUSE3B33E|??老人3|Santa Clause 3, The - The Escape Clause (U)
MONSTERTRUCKBYME|怪物卡?|Monster Trucks Mayhem (U)
HARLEMTROTERBHNE|美?哈林花式?球|Original Harlem Globetrotters, The (U)
KERPLUNKTATIBXCE|激烈碰撞|Ker Plunk!, Toss Across, Tip It (U)
ATV THUNDER B3BE|ATV雷?越野??手|ATV Thunder Ridge Riders (U)
BARBIE12PRCSBB3E|芭比在十二?跳舞的公主?|Barbie in the 12 Dancing Princesses (U)
MATCHBOXMISSBB4E|火柴盒任?|Matchbox Emergency Response + Air, Land & Sea Rescue (U)
PNATASHASSAPBNPE|娜塔莎公主|Princess Natasha (U)
BRATZDIAMONDBXFE|布拉?-永?的?石|Bratz - Forever Diamondz (U)
DORA WORLD ABXPE|朵拉的世界冒?|Dora the Explorer - Dora's World Adventure! (U)
TMNT GBA 1+2BT8E|忍者神?2合1|Teenage Mutant Ninja Turtles +  Turtles 2 - Battle Nexus (U)
JLH: FLASH  BJHE|正?英雄?盟|Justice League Heroes - The Flash (U)
NODDYTOYLANDBNKE|?迪在玩具城的一天|Noddy - A Day in Toyland (U)
BARBIE DM   BBIE|芭比奇幻日?-神秘的高校|Barbie Diaries, The - High School Mystery (U)
TLOS:ANB    B3YE|斯派??奇-新的?始|Legend of Spyro, The - A New Beginning (U)
SWORDCRAFT2 BSKE|召?之夜-??物?2|Summon Night - Swordcraft Story 2 (U)
SHREK SHARK BS7E|史瑞克2合1|2 in 1 - Shrek 2 + Shark Tale (U)
SPONGEBOBCKKBQ4E|海面方?-?自生?卡拉布的生物|SpongeBob SquarePants - Creature from the Krusty Krab (U)
OVERTHEHEDGEBH5I|?笆?????Gang del Bosco, La (I)|
THEMUMMY    AUME|木乃伊|Mummy, The (U)
MOUSE TRAP  B3OE|小游?3合1|Mousetrap, Operation, Simon (U)
HOTSTCHOTWR BQJE|火??胎2合1|Hot Wheels - Stunt Track Challenge + Hot Wheels - World Race (U)
FLUSHED AWAYBLHE|鼠?大冒?|Flushed Away (U)
BESTFRIENDS BHBP|??狗狗好朋友|Hunde & Katzen - Best Friends (E)
HAMMYGOSNUTSBH7P|?笆?????Over the Hedge - Hammy Goes Nuts! (E)|
GTRACERS    BJAP|GT??手|GT Racers (E)
SNOOD2ONVAC B2VE|史奴德2-假期|Snood 2 - Snoods on Vacation (U)
UNO 52      BU5E|扑克52?|Uno 52 (U)
SCURGEHIVE  BHVP|蜂房|Scurge - Hive (E)
TLOS:ANB    B3YP|斯派??奇-新的?始|Legend of Spyro, The - A New Beginning (E)
BRATZDIAMONDBXFD|布拉?-永?的?石|Bratz - Forever Diamondz (G)
TEEN TITAN 2BZUE|小巨人2|Teen Titans 2 (U)
FOSTERS HOMEBFYE|??麻吉|Foster's Home for Imaginary Friends (U)
NICKTOONSBVIBNVE|海???-火山?之?|Nicktoons - Battle for Volcano Island (U)
ZACKANDCODY BZCE|小查?寇弟的??生活|Suite Life of Zack & Cody, The - Tipton Caper (U)
CAMP LAZLO  BLCE|露??營游?|Camp Lazlo - Leaky Lake Games (U)
SPIDER-MAN  BX3E|蜘蛛?2合1|2 in 1 - Spider-Man + Spider-Man 2 (U)
3N1SPORTSPAKB3NE|Majesco?育3合1|Paintball Splat! + Dodgeball + Big Alley Bowling (U)
MV1 ALLIANCEB4ME|漫?英雄???盟|Marvel - Ultimate Alliance (U)
OPEN SEASON BOAX|狩?季?|Open Season (E)
NFS CARBON  BN7E|?品??卡本?谷-?抱都市|Need for Speed Carbon - Own the City (U)
MAJESCOS3IN1BRQE|Majesco?育3合1|3 in 1 - Darts + Roll-a-Ball + Shuffle Bowl (U)
REBELSTAR   BRLP|惑星指令|Rebelstar - Tactical Command (E)
JUKA        BJKE|丘卡和??的危?|Juka and the Monophonic Menace (U)
SCURGEHIVE  BHVE|蜂房|Scurge - Hive (U)
TOMB RAIDER BL8P|?拉克?馥特-古墓?影?奇|Lara Croft Tomb Raider - Legend (E)
SPONGEBOBCKKBQ4P|海面方?-?自生?卡拉布的生物|SpongeBob SquarePants - Creature from the Krusty Krab (E)
TONY HAWK'S BXSE|托尼霍克滑板下坡|Tony Hawk's Downhill Jam (U)
FF5ADVANCE  BZ5E|最?幻想5A|Final Fantasy V Advance (U)
THE GRIM ADVBIEE|比利和曼迪的格子大冒?|Grim Adventures of Billy & Mandy, The (U)
TOMAJERRYGBABJTE|?姆和杰瑞|Tom and Jerry Tales (U)
POKE DUNGEONB24P|口袋妖怪不可思?的迷?-?色救助?|Pokemon Mystery Dungeon - Red Rescue Team (E)
WHO WANTS TOBWJP|?想成???富翁|Who Wants to Be a Millionaire Junior (E)
SIMS2 PETS  B4OE|模?人生2-?物|Sims 2, The - Pets (U)
SCOOBYMOVMONBPUE|海面??2合1|2 in 1 - Scooby-Doo + Scooby-Doo 2 - Monsters Unleashed (U)
SBBFBBNTFFF BU2E|史酷比2合1|SpongeBob - Bikini Bottom + Nicktoons - Freeze Frame Frenzy (U)
PMWANDMPMMM B6PE|吃豆2合1|2 in 1 - Pac-Man World + Ms. Pac-Man - Maze Madness (U)
SHREK 2-PENGBXHE|??加斯加2合1|2 in 1 - Madagascar - Operation Penguin + Shrek 2 (U)
LOONEYTUNES2BLNE|??明星???2合1|Looney Tunes - Dizzy Driving + Looney Tunes - Acme Antics (U)
SPORTSMAN'S B23E|野外狩?2合1|Cabela's Big Game Hunter - 2005 + Rapala Pro Fishing (U)
BIONICLEH   BIHE|?高生化英雄|Bionicle Heroes (U)
DOGZ        B82Y|狗狗|Dogz (E)
TONYHAWKDJ  BXSP|托尼霍克滑板下坡|Tony Hawk's Downhill Jam (E)
BIONICLEH   BIHP|?高生化英雄|Bionicle Heroes (E)
SRTOG2      B2RE|超??器人大?-原?世?2|Super Robot Taisen - Original Generation 2 (U)
SONICGENESISBIJE|刺索尼克-MD移植版|Sonic the Hedgehog - Genesis (U)
WINXQFTCDX  BWVE|魔法俏佳人-X代?任?|WinX Club - Quest for the Codex (U)
HOT WHEELS VAH8P|火??胎-X?速|Hot Wheels - Velocity X (E)
SIMS2 PETS  B4OX|模?人生2-?物|Sims 2, The - Pets (E)
SPIDEY      BC9E|蜘蛛?-???而?|Spider-Man - Battle for New York (U)
ERAGON      BENP|??士|Eragon (E)
ERAGON      BENE|??士|Eragon (U)
HI HI PUFFY BHHP|嗨帕妃?美由美|Hi Hi Puffy AmiYumi - Kaznapped! (E)
TOMAJERRYGBABJTP|?姆和杰瑞|Tom and Jerry Tales (E)
HAPPY FEET EBH3P|快?的大?|Happy Feet (E)
JLH: FLASH  BJHP|正以英雄?盟|Justice League Heroes - The Flash (E)
FLUSHED AWAYBLHP|鼠?流浪?|Flushed Away (E)
BIENEMAJA   BKFX|蜜蜂??|Biene Maja, Die - Klatschmohnwiese in Gefahr (E)
PRINCESSTOWNBQNP|迪斯尼公主皇家冒?|Disney Princess - Royal Adventure (E)
HAPPY FEET  BH3E|快?的大?|Happy Feet (U)
POLARIUMGBA BIIE|通勤一?|Polarium Advance (U)
TONKA ON JOBBT7E|?卡卡?-工作?上|Tonka - On the Job (U)
YGGDRA UNIONBYUE|公主?盟|Yggdra Union - We'll Never Fight Alone (U)
FF6ADVANCE  BZ6J|最?幻想6A|Final Fantasy VI Advance (J)
TOMB RAIDER BL8E|古墓?影-?奇|Lara Croft Tomb Raider - Legend (U)
LIZZIE 2 SE BL4E|摩托英豪A|Lizzie McGuire 2 - Lizzie Diaries (U)
MR ADVANCE  A9ME|迪斯尼2合1|Motoracer Advance (U)
MONT_NEMO   BDZE|平民天後2|2 in 1 - Monsters, Inc. + Finding Nemo (U)
TSPIES 2    B2LE|四眼天?2-?作天王|Totally Spies! 2 - Undercover (U)
HOT WHEELS  BHXE|火??胎-??出局|Hot Wheels - All Out (U)
MARCHPENGUINBQLE|企?的三月|March of the Penguins (U)
WCPOKER     BP9P|世界冠?扑克|World Championship Poker (E)
MATCHBOXMISSBB4P|火柴盒2合1|Matchbox Emergency Response + Air, Land & Sea Rescue (E)
SPIDEY      BC9P|蜘蛛?-???而?|Spider-Man - Battle for New York (E)
CURIOUS GEORB3JP|好奇的?治|Curious George (E)
CHARLOTTE   BCJE|夏洛特的?|Charlotte's Web (U)
F24 STEALTH BYAE|F24魔鬼???|F24 Stealth Fighter (U)
SHREK SMASHNB4IE|史瑞克??|Shrek - Smash n' Crash Racing (U)
ANICENAFRICABFRP|我的非洲?物中心|My Animal Centre in Africa (E)
NICKTOONS003MN3E|尼克通?影第3?|Nicktoons Collection - Volume 3 (U)
TRINGO      BTJP|方?拼?|Tringo (E)
RAYMAN4     BQ3E|雷曼-?狂的兔子|Rayman - Raving Rabbids (U)
SUPERMAN R  BQXE|超人??-孤?的要塞|Superman Returns - Fortress of Solitude (UE)
FF4ADVANCE  BZ4J|最?幻想4A|Final Fantasy IV Advance (J)
WINXQFTCDX  BWVP|魔法俏佳人-法典的任?|WinX Club - Quest for the Codex (E)
RAYMAN4     BQ3P|雷曼-?狂的兔子|Rayman - Raving Rabbids (E)
MAZESOFFATE BFQE|迷?的?杯|Mazes of Fate (U)
WINNIE-RM3  BWZP|小熊?尼2合1|Winnie the Pooh's Rumbly Tumbly Adventure + Rayman 3 (E)
SBSPMOVIEFFFB2BP|海面方?2合1|SpongeBob Movie + SpongeBob Freeze Frame Frenzy (E)
SKYDANCERS  B4DP|空中之舞-魔法?翔|Sky Dancers - They Magically Fly! (E)
CHICKENSHOT2B6GP|母?射?2|Chicken Shoot 2 (E)
HELLOKITTY  B86P|?蒂的快?聚?|Hello Kitty - Happy Party Pals (E)
CABBAGE PATCBCGP|?心菜娃娃|Cabbage Patch Kids - The Patch Puppy Rescue (E)
TXRA        BTZP|?京?限?速|Tokyo Xtreme Racer Advance (E)
CARTONETW003MCPE|卡通明星?影-白金版|Cartoon Network Collection - Premium Edition (U)
ROBORUMBLE  BHQP|特工雨果|Agent Hugo - Roborumble (E)
SBFOP       BX6E|海面方?2合1|SpongeBob - Bikini Bottom + Fairly Odd Parents! - Rules (U)
MP3PLAYER   ZMDE|任天堂MP3播放器|Nintendo MP3 Player (E)
AVATAR      BQZP|降世神通-Aang?奇|Avatar - The Legend of Aang (E)
BACKTOSTONE BBCE|重返石?城|Back to Stone (U)
TROLLZHAIRAFBT6Y|奇幻漫舞|Trollz - Hair Affair! (E)
ARTHUR      B2NP|?瑟和迷你王?|Arthur and the Minimoys (E)
KINGOFEXNEOBAKOE|拳皇EX-新的血?|King of Fighters EX, The - NeoBlood (U)
BRATZ BABYZ BBZP|布拉?洋娃娃|Bratz - Babyz (E)
DOGZ FASHIONBFEP|狗狗?尚|Dogz - Fashion (E)
MEDALOFHONORAUGP|???章-地下行?|Medal of Honor - Underground (E)(Zoo Digital)
OPEN SEASON BOAP|狩?季?|Open Season (E)
ED EDD EDDY AE3E|艾、艾德、艾迪三?好朋友|Ed, Edd n Eddy - Jawbreakers! (U)
SHREK 2/MADABXGE|??加斯加史瑞克2合1|2 in 1 - Madagascar + Shrek 2 (U)
FAIRLYODDAGBBF2P|反斗家族2-暗影??|Fairly Odd Parents!, The - Shadow Showdown (E)
BRATZ BABYZ BBZE|布拉?洋娃娃|Bratz - Babyz (U)
MV1 ALLIANCEB4MP|漫?英雄-???盟|Marvel - Ultimate Alliance (E)
DIS PIX CARSBCAY|汽????|Cars (E)
PRANGERS_SPDBRDY|雷霆??-空?巡?三人?|Power Rangers S.P.D. (E)
NEMO NEMO2  BFWZ|海底???2合1|2 in 1 - Finding Nemo + The Continuing Adventures (E)
DANNYPHANTOMBUEP|丹尼幻影-???人|Danny Phantom - The Ultimate Enemy (E)
MONSTERHOUSEBQ7P|怪物?墅|Monster House (E)
NEMOINCREDIBBINZ|超人???2合1|2 in 1 - Buscando a Nemo + Increibles, Los (E)
ROCKEMSOCKEMBR7P|十三??器人|Rock'em Sock'em Robots (E)
BRATZ ROCK ABRRS|布拉?-??天使|Bratz - Rock Angelz (S)
TROLLZHAIRAFBT6X|奇幻漫舞|Trollz - Hair Affair! (E)
HARLEMGLOBE BHNP|哈林?球?|Original Harlem Globetrotters, The (E)
KURESHIN2006BC2S|??小新2|Shinchan contra los Munecos de Shock Gahn (S)
ARTHUR      B2NE|?瑟和迷你王?|Arthur and the Invisibles (U)
DORA DBL PAKB2EE|探?家朵拉2合1|Dora - Pirate Pig's Treasure + Super Star Adventures! (U)
TSPIES 2    B2LP|??少女?2|Totally Spies! 2 - Undercover (E)
ALEX RIDER  BAWX|阿?克斯?德-?暴??者|Alex Rider - Stormbreaker (E)
BARBIE12PREUBB3P|芭比和12?跳舞的公主|Barbie in the 12 Dancing Princesses (E)
SHAMUSADV   BBAP|?姆的深海冒?|Shamu's Deep Sea Adventures (E)
BARBIE DM   BBIP|芭比日?-高校的秘密|Barbie Diaries, The - High School Mystery (E)
NODDYTOYLANDBNKP|?迪-在玩具世界的一天|Noddy - A Day in Toyland (E)
BRATZDIAMONDBXFP|布拉?-永?的?石|Bratz - Forever Diamondz (E)
DOGZ        B82P|狗狗|Dogz (E)
SS DBL PACK BQWE|草莓娃娃-夏日??|Strawberry Shortcake - Summertime Adventure - Special Ed (U)
NEMOINCREDIBBINY|海底???2合1|2 in 1 - Alla Ricerca di Nemo + Incredibili, Gli (E)
2IN1_ADV_CHUBW3P|世嘉游?2合1|2 in 1 - Sonic Advance + Chu Chu Rocket! (E)
ALEDERMANNEUBPVX|??精英|Pippa Funnell - Stable Adventure (E)
POKEMON FIREBPRJ|口袋妖怪-火?|Pocket Monsters - Fire Red (J)
CANESPECFR00MCSF|GBA?影卡通?道集?-特?版|Cartoon Network Collection - Edition Speciale (F)
TMNTV01FR000MTMF|GBA?影-忍者神?|Teenage Mutant Ninja Turtles - Le Demenagement (F)
YUGIOH01FR00MYGF|GBA?影-游?王|Yu-Gi-Oh - Yugi vs Joey (F)
OVERTHEHEDGEBH5F|?笆?????Nos Voisins - Les Hommes (F)|
NEMOINCREDIBBINX|海底???2合1|2 in 1 - Finding Nemo + Incredibles, The (E)
MEIN PFERD  BEFP|最好的朋友-我的??|Best Friends - My Horse (E)
LUR2        BYPX|??精英2|Pippa Funell 2 (E)
UNOSKIPBO   BUQP|?牌游?2合1|2 Game Pack - Uno + Skip-Bo (E)
SPONGECOMP1EBSZP|海?方?2合1|2 in 1 - SpongeBob - Supersponge + Battle for Bikini Bottom (E)
SCRABBLESCRABLAP|混?拼字|Scrabble Scramble (E)
JIMMYNEUAOTTBJYF|Jimmy Neutron - Attaque des Twonkies (F)|Jimmy Neutron - Attaque des Twonkies (F)
SUPER MARIODAX4J|Super Mario Advance 4 (v02)(J)|Super Mario Advance 4 (v02)(J)
ATV THUNDER B3BP|ATV Thunder Ridge Riders (E)|ATV Thunder Ridge Riders (E)
MONSTERTRUCKBYMP|Monster Trucks Mayhem (E)|Monster Trucks Mayhem (E)
PRINCESS NATBNPP|Princess Natasha - Student Secret Agent (E)|Princess Natasha - Student Secret Agent (E)
FF6ADVANCE  BZ6E|Final Fantasy VI Advance (U)|Final Fantasy VI Advance (U)
POLLY POCKETB3FP|Polly! Pocket - Super Splash Island (E)|Polly! Pocket - Super Splash Island (E)
ALLGROWNUP  BALX|All Grown Up - Express Yourself (E)|All Grown Up - Express Yourself (E)
SHREK SMASHNB4IP|Shrek Smash n' Crash Racing (E)|Shrek Smash n' Crash Racing (E)
Over_the_HedgeBH5P|Over the Hedge (E)|Over the Hedge (E)
GHOST RIDER BR8E|Ghost Rider  (U)|Ghost Rider  (U)
SHREK 2/MADABXGP|2 in 1 Fun Pack - Madagascar + Shrek 2 (E)|2 in 1 Fun Pack - Madagascar + Shrek 2 (E)
NEMO NEMO2  BFWX|2 in 1 - Finding Nemo + Finding Nemo TCA (E)|2 in 1 - Finding Nemo + Finding Nemo TCA (E)
CHARLOTTE   BCJP|Charlotte's Web (E)|Charlotte's Web (E)
SD_MP&MU_FREBPUF|2 in 1 - Scooby Doo le Film + Scooby Doo 2 (F)|2 in 1 - Scooby Doo le Film + Scooby Doo 2 (F)
DIS PIX CARSBCAZ|Cars  (E)|Cars  (E)
TSTAR       B9SP|Trick Star (E)|Trick Star (E)
ZOEY 101    BZYE|Zoey 101 (U)|Zoey 101 (U)
POLLY POCKETB3FE|Polly Pocket! (U)|Polly Pocket! (U)
BB_&_DP_ITALBWBI|2 Games in 1 - Koda Fratello Orso + Disney Principesse (I)|2 Games in 1 - Koda Fratello Orso + Disney Principesse (I)
KID PADDLE  BYLP|Kid Paddle (E)|Kid Paddle (E)
NEMO2INCPACKBNEE|2 in 1 - The Incredibles + Finding Nemo - TCA (U)|2 in 1 - The Incredibles + Finding Nemo - TCA (U)
WILDEKERLE02BXWD|Die Wilden Fussball Kerle - Gefahr im Wilde Kerle Land (G)|Die Wilden Fussball Kerle - Gefahr im Wilde Kerle Land (G)
TROLLZHAIRAFBT6P|Trollz - Hair Affair (E)|Trollz - Hair Affair (E)
UNO FREEFALLBUIE|Uno Freefall (U)|Uno Freefall (U)
OVERTHEHEDGEBH5H|Over the Hedge - Beesten Bij de Buren (NL)|Over the Hedge - Beesten Bij de Buren (NL)
HOT WHEELS  BHXP|Hot Wheels - All Out (E)|Hot Wheels - All Out (E)
DRAKEANDJOSHAJYE|Drake & Josh (U)|Drake & Josh (U)
DANNYPHANTOMBQYD|Danny Phantom - Dschungelstadt (G)|Danny Phantom - Dschungelstadt (G)
TMNT        BEXE|TMNT (U)|TMNT (U)
NICKELODEON BI7E|4 Games on One Game Pak - Nickelodeon (U)|4 Games on One Game Pak - Nickelodeon (U)
TMNT        BEXP|TMNT - Teenage Mutant Ninja Turtles (E)|TMNT - Teenage Mutant Ninja Turtles (E)
SD_MP&MU_ENGBPUP|2 Games in 1 - Scooby-Doo + Scooby-Doo 2 (E)|2 Games in 1 - Scooby-Doo + Scooby-Doo 2 (E)
SHREK 2-PENGBXHP|2 in 1 - Shrek 2 + Madagascar Operation Penguin (E)|2 in 1 - Shrek 2 + Madagascar Operation Penguin
MONSNEMO_DUTBDZH|2 Games in 1 - Monster en Co + Finding Nemo (NL)|2 Games in 1 - Monster en Co + Finding Nemo (NL)
UNO 52      BU5P|Uno 52 (E)|Uno 52 (E)
MTR         BRHE|Meet the Robinsons (U)|Meet the Robinsons (U)
SS_&_RGW_FREBRSF|2 in 1 - Spongebob Squarepants + Les Razmoket (F)|2 in 1 - Spongebob Squarepants + Les Razmoket (F)
PETZVET     BNBE|Petz Vet (U)|Petz Vet (U)
DOGZ2       BIME|Dogz 2 (U)|Dogz 2 (U)
MTR         BRHP|Meet the Robinsons (E)|Meet the Robinsons (E)
DANCE BEAT  ABYP|Britney's Dance Beat (E)|Britney's Dance Beat (E)
DORA SPR STRBDOP|Dora the Explorer - Super Star Adventures! (E)|Dora the Explorer - Super Star Adventures! (E)
FF5ADVANCE  BZ5P|Final Fantasy V Advance (E)|Final Fantasy V Advance (E)
MARCHP      BQLP|March of the Penguins (E)|March of the Penguins (E)
CANEPLATFR00MCNF|GBA Video - Cartoon Network Collection Edition Platinum (F)|GBA Video - Cartoon Network Collection Edition Platinum (F)
SPIDERMAN3  BI3D|Spider-Man 3 (DE)|Spider-Man 3 (DE)
POSTMAN PAT BROP|Postman Pat and the Greendale Rocket (E)|Postman Pat and the Greendale Rocket (E)
SPIDERMAN3  BI3E|Spider-Man 3 (U)|Spider-Man 3 (U)
SPIDERMAN3  BI3P|Spider-Man 3 (E)|Spider-Man 3 (E)
SPIDERMAN3  BI3S|Spider-Man 3 (ES)|Spider-Man 3 (ES)
MMSBREAKEM  BEME|M&M's Break' Em (U)|M&M's Break' Em (U)
DIS PIX CARSBCAX|Cars (E)|Cars (E)
TIERPENSION BQTX|Mijn Dierenpension (NL)|Mijn Dierenpension (NL)
TIERPRAXIS  BQVX|Mijn Dierenpraktijk (NL)|Mijn Dierenpraktijk (NL)
MIJNMANEGEDUBPVY|Paard & Pony - Mijn Manege (NL)|Paard & Pony - Mijn Manege (NL)
LUR2        BYPY|Paard & Pony - Paard in Galop (NL)|Paard & Pony - Paard in Galop (NL)
SPIDERMAN3  BI3I|Spider-Man 3 (IT)|Spider-Man 3 (IT)
SHREK 3     B3HE|Shrek the Third (U)|Shrek the Third (U)
MLB 2K7     B2YE|Major League Baseball 2k7 (U)|Major League Baseball 2k7 (U)
SBSP BFVI   BNVP|SpongeBob SquarePants and Friends - Battle for Volcano Island (E)|SpongeBob SquarePants and Friends - Battle for Volcano Island (E)
LK_AND_DP   BLPP|2 Games in 1 - Disney Princess + The Lion King (E)|2 Games in 1 - Disney Princess + The Lion King (E)
COCOTO KART BC5P|Cocoto - Kart Racer (E)|Cocoto - Kart Racer (E)
DOGZ2       BIMP|Dogz 2 (E)|Dogz 2 (E)
UNO FREEFALLBUIP|Uno Free Fall (E)|Uno Free Fall (E)
SURFS UP    BXUE|Surf's Up (U)|Surf's Up (U)
2IN1_BTL_CHUBW7P|2 Games in 1 - Sonic Battle + ChuChu Rocket! (E)|2 Games in 1 - Sonic Battle + ChuChu Rocket! (E)
SHREK 3     B3HP|Shrek the Third (E)|Shrek the Third (E)
2IN1_PIN_COLBW8P|2 Games in 1 - Sonic Pinball + Columns Crown (E)|2 Games in 1 - Sonic Pinball + Columns Crown (E)
FF6ADVANCE  BZ6P|Final Fantasy VI Advance (E)|Final Fantasy VI Advance (E)
DOGZ2       BIMX|Dogz 2 (E)|Dogz 2 (E)
SPIDERMAN3  BI3F|Spider-Man 3 (F)|Spider-Man 3 (F)
RATATOUILLE BNLE|Ratatouille (U)|Ratatouille (U)
HORSEZ      BHUE|Horsez (U)|Horsez (U)
DOGZ        B82X|Dogz (fre)(E)|Dogz (fre)(E)
TIERPENSION BQTF|Lea - Passion Veterinaire (F)|Lea - Passion Veterinaire (F)
BACKTOSTONE BBCP|Back to Stone (E)|Back to Stone (E)
COCOTO-PF   BC8P|Cocoto Platform Jumper (E)|Cocoto Platform Jumper (E)
HARRYPHOENI BJXE|Harry Potter and the Order of the Phoenix (U)|Harry Potter and the Order of the Phoenix (U)
MEIN PFERDE B94D|2 in 1 - Pferd & Pony - Mein Pferdehof + Lass Uns Reiten 2 (De)|2 in 1 - Pferd & Pony - Mein Pferdehof + Lass Uns Reiten 2 (De)
RATATOUILLE BNLY|Ratatouille  (E)|Ratatouille  (E)
F-ZERO ADVANAFZC|Jisu F-ZERO Weilai Saiche (C)|Jisu F-ZERO Weilai Saiche (C)
RATATOUILLEBNLX|Ratatouille (E)|Ratatouille (E)
SURFS UPBXUX|Surf's Up (E)|Surf's Up (E)
CRASHTITANSBQCE|Crash of the Titans (U)|Crash of the Titans (U)
TLOS TENBU7E|The Legend of Spyro - The Eternal Night (U)|The Legend of Spyro - The Eternal Night (U)
ARCTIC TALEBB5E|Arctic Tale (U)|Arctic Tale (U)
BRATZ MOVIEBBUE|Bratz - The Movie (U)|Bratz - The Movie (U)
DEALORNODEALBZNE|Deal or No Deal (U)|Deal or No Deal (U)
PUPPYLUVBYXE|Puppy Luv - Spa and Resort (U)|Puppy Luv - Spa and Resort (U)
AVATARBBWE|Avatar - The Last Airbender - The Burning Earth (U)|Avatar - The Last Airbender - The Burning Earth (U)
4PACKRACINGBI4E|4 in 1 - GT Advance 1-3 - Moto GP (U)|4 in 1 - GT Advance 1-3 - Moto GP (U)
NICK ATTACKBUJE|Nicktoons - Attack of the Toybots (U)|Nicktoons - Attack of the Toybots (U)
SPONGEBOB APBZXE|SpongeBob's Atlantis Squarepantis (U)|SpongeBob's Atlantis Squarepantis (U)
BARBIEIPBBNE|Barbie as the Island Princess (U)|Barbie as the Island Princess (U)
BRATZ MOVIEBBUD|Bratz - The Movie (G)|Bratz - The Movie (G)
BB_&_DP_ENG_BWBP|2 Games in 1 - Brother Bear + Disney Princess (E)|2 Games in 1 - Brother Bear + Disney Princess (E)
CRASHTITANSBQCP|Crash of the Titans (E)|Crash of the Titans (E)
BRATZ MOVIEBBUX|Bratz - The Movie (E)|Bratz - The Movie (E)
RATATOUILLEBNLP|Ratatouille (E)|Ratatouille (E)
CRASHSPYRO4B54E|Crash & Spyro Superpack - The Huge Adventure + Season of Ice (U)|Crash & Spyro Superpack - The Huge Adventure + Season of Ice (U)
SURFS UPBXUP|Surf's Up (E)|Surf's Up (E)
CARSMATERBCPE|Cars Mater-National Championship (U)|Cars Mater-National Championship (U)
PETZ-HAM2AJHE|Petz - Hamsterz Life 2 (U)|Petz - Hamsterz Life 2 (U)
ENCHANTEDBZRE|Enchanted - Once Upon Andalasia (U)|Enchanted - Once Upon Andalasia (U)
NICK ATTACKBUJX|SpongeBob and Friends - Attack of the Toybots (E)|SpongeBob and Friends - Attack of the Toybots (E)
HSMBJ2E|High School Musical - Livin' the Dream (U)|High School Musical - Livin' the Dream (U)
MATH PATROL:BIYE|Math Patrol - The Kleptoid Threat (U)|Math Patrol - The Kleptoid Threat (U)
AVATARBBWP|Avatar - The Legend of Aang - The Burning Earth (E)|Avatar - The Legend of Aang - The Burning Earth (E)
CARSMATERNATBCPP|Cars Mater-National Championship (E)|Cars Mater-National Championship (E)
IGNITION COLBIVP|Ignition Collection - Volume 1 (3 Games in 1) (E)|Ignition Collection - Volume 1 (3 Games in 1) (E)
THE BEE GAMEBKFE|The Bee Game (U)|The Bee Game (U)
TLOS TENBU7P|The Legend of Spyro - The Eternal Night (E)|The Legend of Spyro - The Eternal Night (E)
HPCOLLECTIOBJPP|Harry Potter Collection (E)|Harry Potter Collection (E)
IRON_KIDBIRK|Iron Kid (K)|Iron Kid (K)
LETS RIDE FFBEFE|Let's Ride - Friends Forever (U)|Let's Ride - Friends Forever (U)
WORD SAFARI:ADVE|World Safari - The Friendship Totems (U)|World Safari - The Friendship Totems (U)
BESTFRIENDSBHBE|Best Friends - Dogs & Cats (U)|Best Friends - Dogs & Cats (U)
LEGENDZSHIMALJK|Legendz - Buhwarhaneun Siryeonyi Seom (K)|Legendz - Buhwarhaneun Siryeonyi Seom (K)
SAMURAI_DST1AOSE|Samurai Deeper Kyo (U)|Samurai Deeper Kyo (U)
MADAGASCARBGZH|Madagascar (NL)|Madagascar (NL)
CAMP LAZLOBLCP|Camp Lazlo - Leaky Lake Games (E)|Camp Lazlo - Leaky Lake Games (E)
FOSTERS HOMEBFYP|Fosters Home for Imaginary Friends (E)|Fosters Home for Imaginary Friends (E)
SUPER ROBOTAOGP|Super Robot Taisen OG (E)|Super Robot Taisen OG (E)
YGGDRA UNIONBYUP|Yggdra Union (E)|Yggdra Union (E)
BRATZ MOVIEBBUP|Bratz - The Movie (E)|Bratz - The Movie (E)
PIXELINEBQ9Q|Pixeline i Pixieland (E)|Pixeline i Pixieland (E)
SUPER MARIO FSMJ|FC Mini Vol. 01 - Super Mario Bros. (J)(Hot Mario Campaign)|FC Mini Vol. 01 - Super Mario Bros. (J)(Hot Mario Campaign)
SUPER ROBOT2FSRJ|Famicom Mini - Dai 2 Ji Super Robot Taisen (J)|Famicom Mini - Dai 2 Ji Super Robot Taisen (J)
MANANITOS   BMNS|Morning Adventure, The (S)|Morning Adventure, The (S)
Z-GUNDAM    FGZJ|Z高?|Famicom Mini - Kido Senshi ZGundam Hot Scramble (J)
HIKARUNOGO  PAHTJ|Hikaru no Go - Taikenban (J)|Hikaru no Go - Taikenban (J)
FRUITCHASE  ADCE|Fruit Chase (U)|Fruit Chase (U)
HAUNTEDMANSIALIE|The Haunted Mansion (U)|The Haunted Mansion (U)
KIEN        XXXE|Kien (U)|Kien (U)
SONICADVANC3B3SP|Sonic Advance 3 Beta (E)|Sonic Advance 3 Beta (E)
Z-GUNDAM    FGZJ|Famicom Mini Series Kido Senshi Z Gundam Hot Scramble (J)|Famicom Mini Series Kido Senshi Z Gundam Hot Scramble (J)
BOKUTAI     A3IJ|Bokura no Taiyou - Taiyou Action RPG (JP)(E3 Demo)|Bokura no Taiyou - Taiyou Action RPG (JP)(E3 Demo)
SUPER ROBOT2FSRJ|Famicom Mini Dai 2 Ji Super Robot Taisen (Promo)(J)|Famicom Mini Dai 2 Ji Super Robot Taisen (Promo)(J)
PocketNESS  PNES|NES emulator|NES emulator
MOTOCHAL    0000|Motocross Challenge|Motocross Challenge